lang	fam
ads	adsl
asp	adsl
bog	adsl
cds	adsl
esl	adsl
eth	adsl
gse	adsl
gus	adsl
hsl	adsl
lbs	adsl
mzc	adsl
mzy	adsl
nbs	adsl
nsi	adsl
sfs	adsl
sgx	adsl
tse	adsl
tza	adsl
ugn	adsl
xki	adsl
xms	adsl
zib	adsl
zsl	adsl
aal	afas
aao	afas
aar	afas
aas	afas
abh	afas
abv	afas
acm	afas
acq	afas
acw	afas
acx	afas
acy	afas
adf	afas
aeb	afas
aec	afas
afb	afas
agj	afas
ahg	afas
aii	afas
aij	afas
aiz	afas
ajp	afas
ajt	afas
aju	afas
ajw	afas
alw	afas
amf	afas
amh	afas
amw	afas
anc	afas
ank	afas
apc	afas
apd	afas
arb	afas
arq	afas
ars	afas
arv	afas
ary	afas
arz	afas
auj	afas
auo	afas
auz	afas
avl	afas
awn	afas
ayh	afas
ayl	afas
ayn	afas
ayp	afas
bbt	afas
bcq	afas
bcw	afas
bcy	afas
bde	afas
bdm	afas
bdn	afas
bds	afas
bej	afas
bhm	afas
bhn	afas
bhs	afas
bid	afas
bjf	afas
bji	afas
bnl	afas
bob	afas
bol	afas
bso	afas
bst	afas
bsw	afas
bta	afas
btf	afas
bux	afas
bva	afas
bvf	afas
bvh	afas
bvw	afas
bwo	afas
bwr	afas
bxe	afas
bxq	afas
byn	afas
cie	afas
ckl	afas
ckq	afas
cky	afas
cla	afas
cld	afas
cnu	afas
cop	afas
cra	afas
cuv	afas
daa	afas
dal	afas
dbb	afas
dbp	afas
dbq	afas
dbr	afas
dgh	afas
dim	afas
dkx	afas
dme	afas
dot	afas
dox	afas
doz	afas
drs	afas
dsh	afas
dwa	afas
dzd	afas
elo	afas
fie	afas
fli	afas
gab	afas
gax	afas
gaz	afas
gde	afas
gdf	afas
gdk	afas
gdl	afas
gdq	afas
gdu	afas
gea	afas
gek	afas
gew	afas
gex	afas
gez	afas
gft	afas
ggh	afas
gha	afas
gho	afas
gid	afas
gis	afas
giz	afas
gji	afas
glo	afas
glw	afas
gmo	afas
gnc	afas
gnd	afas
gou	afas
gow	afas
gqa	afas
grd	afas
grr	afas
gru	afas
gwd	afas
gwn	afas
gza	afas
hae	afas
har	afas
hau	afas
hbb	afas
hbo	afas
hdy	afas
heb	afas
hed	afas
hia	afas
hig	afas
hna	afas
hod	afas
hoh	afas
hoz	afas
hrt	afas
hss	afas
huy	afas
hwo	afas
hya	afas
ior	afas
irk	afas
jaf	afas
jbe	afas
jbn	afas
jeu	afas
jia	afas
jie	afas
jii	afas
jim	afas
jmb	afas
jmi	afas
jnj	afas
jrt	afas
juu	afas
jye	afas
kab	afas
kai	afas
kbr	afas
kbz	afas
kcs	afas
kcx	afas
ker	afas
kil	afas
kkr	afas
kks	afas
kna	afas
kof	afas
kot	afas
kpa	afas
kqd	afas
kqp	afas
kqx	afas
kqy	afas
kso	afas
ksq	afas
ktb	afas
ktc	afas
kuh	afas
kul	afas
kvf	afas
kvi	afas
kvj	afas
kwl	afas
kxc	afas
kxh	afas
ldd	afas
lhs	afas
liq	afas
lln	afas
lme	afas
lsd	afas
maf	afas
mcn	afas
mcw	afas
mdx	afas
mdy	afas
meq	afas
mes	afas
mew	afas
mey	afas
mfh	afas
mfi	afas
mfj	afas
mfk	afas
mfl	afas
mfm	afas
mfx	afas
mid	afas
mif	afas
mje	afas
mjs	afas
mkf	afas
mlj	afas
mlr	afas
mlt	afas
mlw	afas
mmf	afas
mmy	afas
mou	afas
moy	afas
moz	afas
mpg	afas
mpi	afas
mpk	afas
mqb	afas
mrt	afas
mse	afas
msv	afas
mtl	afas
mub	afas
mug	afas
muj	afas
muu	afas
muy	afas
mvh	afas
mvz	afas
mxf	afas
mxu	afas
myf	afas
myo	afas
mys	afas
myz	afas
mzb	afas
nbh	afas
ndm	afas
ngi	afas
ngs	afas
ngw	afas
ngx	afas
nja	afas
nmi	afas
nnc	afas
nnn	afas
noz	afas
orc	afas
oua	afas
oyd	afas
pbi	afas
pcw	afas
pip	afas
piy	afas
plj	afas
pqa	afas
rel	afas
rif	afas
saa	afas
sam	afas
say	afas
scw	afas
sds	afas
sgw	afas
she	afas
shi	afas
shu	afas
shv	afas
shy	afas
sid	afas
sir	afas
siz	afas
sjs	afas
smp	afas
sok	afas
som	afas
sor	afas
sqt	afas
ssh	afas
ssn	afas
ssy	afas
sur	afas
swn	afas
swq	afas
swy	afas
syc	afas
syk	afas
syn	afas
sze	afas
tak	afas
tal	afas
tan	afas
taq	afas
tax	afas
tdk	afas
tgd	afas
thv	afas
thz	afas
tia	afas
tig	afas
tir	afas
tjo	afas
tmc	afas
tmr	afas
tng	afas
tqq	afas
trg	afas
trj	afas
tru	afas
tsb	afas
tsh	afas
ttq	afas
ttr	afas
twc	afas
tzm	afas
ubi	afas
udl	afas
vem	afas
wal	afas
wbj	afas
wji	afas
wka	afas
xan	afas
xed	afas
xmd	afas
xmj	afas
xst	afas
xuf	afas
yhd	afas
ymm	afas
yud	afas
zah	afas
zay	afas
zaz	afas
zen	afas
zim	afas
ziz	afas
zns	afas
zrn	afas
zua	afas
zuy	afas
zwa	afas
cet	afis
bqd	afun
gdm	afun
ime	afun
kah	afun
ldq	afun
rer	afun
vkj	afun
wma	afun
woy	afun
yax	afun
yei	afun
alc	alac
kbf	alac
aaq	algi
abe	algi
alq	algi
arp	algi
atj	algi
ats	algi
bla	algi
chy	algi
ciw	algi
crj	algi
crk	algi
crl	algi
crm	algi
crr	algi
csw	algi
cwd	algi
kic	algi
lmz	algi
mez	algi
mia	algi
mic	algi
mjy	algi
moe	algi
mof	algi
nnt	algi
nsk	algi
nwa	algi
ojb	algi
ojc	algi
ojg	algi
ojs	algi
ojw	algi
otw	algi
pim	algi
pot	algi
pqm	algi
psy	algi
sac	algi
sjw	algi
umu	algi
unm	algi
wam	algi
wiy	algi
yur	algi
aib	altc
alt	altc
atv	altc
azb	altc
azj	altc
bak	altc
bgx	altc
bxm	altc
bxr	altc
bxu	altc
chg	altc
chv	altc
cjs	altc
clw	altc
crh	altc
dlg	altc
drh	altc
dta	altc
eve	altc
evn	altc
gag	altc
gld	altc
ili	altc
jct	altc
juc	altc
kaa	altc
kaz	altc
kdr	altc
khk	altc
kim	altc
kir	altc
kjh	altc
klj	altc
kmz	altc
krc	altc
kum	altc
kxs	altc
mhj	altc
mjg	altc
mnc	altc
mvf	altc
neg	altc
nog	altc
oaa	altc
oac	altc
orh	altc
peh	altc
qxq	altc
sah	altc
sce	altc
sjo	altc
slq	altc
slr	altc
tat	altc
tuk	altc
tur	altc
tyv	altc
ude	altc
uig	altc
ulc	altc
uum	altc
uzn	altc
uzs	altc
xal	altc
ybe	altc
yuy	altc
amt	amto
mmp	amto
abj	anda
aci	anda
ack	anda
acl	anda
akj	anda
akm	anda
akx	anda
aky	anda
anq	anda
apq	anda
okj	anda
oon	anda
std	anda
aai	anes
aaw	anes
aaz	anes
abc	anes
abd	anes
abf	anes
abl	anes
abp	anes
abx	anes
ace	anes
adr	anes
aek	anes
agf	anes
agk	anes
agn	anes
agp	anes
agt	anes
agv	anes
agw	anes
agy	anes
agz	anes
ahb	anes
ahe	anes
aia	anes
aie	anes
ais	anes
aix	anes
aji	anes
akb	anes
akg	anes
akl	anes
akr	anes
akt	anes
alj	anes
alm	anes
alo	anes
alp	anes
alu	anes
ami	anes
amk	anes
amq	anes
amv	anes
and	anes
ane	anes
anx	anes
aok	anes
aol	anes
aor	anes
aoz	anes
apb	anes
apg	anes
apo	anes
app	anes
apr	anes
aps	anes
apx	anes
aqn	anes
aqr	anes
asl	anes
asz	anes
atd	anes
atk	anes
atl	anes
atm	anes
atp	anes
atq	anes
att	anes
aty	anes
atz	anes
aua	anes
aud	anes
aui	anes
aul	anes
auq	anes
aut	anes
avb	anes
axx	anes
ays	anes
ayt	anes
ayy	anes
azr	anes
azt	anes
baa	anes
bac	anes
baj	anes
ban	anes
bay	anes
bbc	anes
bbn	anes
bbv	anes
bcd	anes
bch	anes
bcl	anes
bcm	anes
bcu	anes
bcx	anes
bdb	anes
bdd	anes
bdg	anes
bdl	anes
bdr	anes
bdx	anes
bed	anes
beg	anes
bei	anes
bek	anes
bep	anes
bfg	anes
bgb	anes
bgi	anes
bgs	anes
bgt	anes
bgy	anes
bgz	anes
bhc	anes
bhk	anes
bhp	anes
bhq	anes
bhr	anes
bhv	anes
bhw	anes
bhz	anes
biq	anes
bjk	anes
bjl	anes
bjn	anes
bjq	anes
bjx	anes
bkb	anes
bkd	anes
bke	anes
bki	anes
bkn	anes
bkr	anes
bks	anes
bku	anes
bkx	anes
bkz	anes
bld	anes
blf	anes
blg	anes
blj	anes
bln	anes
blp	anes
blq	anes
bls	anes
blw	anes
blx	anes
blz	anes
bmc	anes
bmk	anes
bmm	anes
bmn	anes
bna	anes
bnb	anes
bnc	anes
bnd	anes
bne	anes
bnf	anes
bnj	anes
bnk	anes
bnn	anes
bno	anes
bnp	anes
bnq	anes
bnr	anes
bnu	anes
bny	anes
boc	anes
bpa	anes
bpg	anes
bpk	anes
bpr	anes
bps	anes
bpz	anes
bqr	anes
brj	anes
brr	anes
brs	anes
brz	anes
bsb	anes
bsd	anes
bsm	anes
bsu	anes
bsy	anes
btd	anes
bth	anes
btj	anes
btm	anes
btn	anes
bto	anes
btp	anes
btr	anes
bts	anes
btw	anes
btx	anes
bty	anes
btz	anes
buc	anes
bug	anes
buk	anes
bup	anes
bvc	anes
bvd	anes
bve	anes
bvk	anes
bvt	anes
bvu	anes
bwa	anes
bwb	anes
bwd	anes
bwf	anes
bwv	anes
bxa	anes
bxf	anes
bxh	anes
bya	anes
byd	anes
byq	anes
bzb	anes
bzg	anes
bzh	anes
bzl	anes
bzn	anes
bzq	anes
cal	anes
cam	anes
ceb	anes
cgc	anes
cha	anes
chk	anes
cia	anes
cir	anes
cja	anes
cje	anes
cjm	anes
ckv	anes
clu	anes
cml	anes
coa	anes
cps	anes
crc	anes
cts	anes
cyo	anes
dac	anes
dad	anes
daw	anes
dbj	anes
ddi	anes
ddw	anes
dgc	anes
dgg	anes
dhv	anes
dij	anes
dix	anes
djo	anes
dkk	anes
dkr	anes
dmg	anes
dmr	anes
dms	anes
dmv	anes
dnk	anes
dob	anes
dok	anes
don	anes
dor	anes
dpp	anes
drg	anes
drn	anes
dro	anes
dru	anes
dsn	anes
dtb	anes
dtp	anes
dtr	anes
due	anes
duf	anes
dul	anes
dun	anes
duo	anes
dup	anes
duq	anes
duw	anes
duy	anes
dva	anes
dww	anes
dyg	anes
dyk	anes
elp	anes
elu	anes
emb	anes
emi	anes
emw	anes
end	anes
eni	anes
eno	anes
erg	anes
erk	anes
erw	anes
etn	anes
faf	anes
far	anes
fij	anes
fil	anes
fos	anes
frd	anes
frt	anes
fud	anes
fut	anes
fwa	anes
gad	anes
gal	anes
gar	anes
gay	anes
gdd	anes
gdg	anes
gei	anes
ges	anes
gfk	anes
gga	anes
ggt	anes
ghn	anes
gil	anes
gip	anes
gmb	anes
gnq	anes
goc	anes
goo	anes
gop	anes
goq	anes
gor	anes
gri	anes
grm	anes
grw	anes
grz	anes
gve	anes
gvs	anes
gzn	anes
hah	anes
hao	anes
haw	anes
hbu	anes
heg	anes
hgw	anes
hik	anes
hil	anes
hiw	anes
hla	anes
hnn	anes
hoa	anes
hob	anes
hot	anes
hov	anes
hrk	anes
hro	anes
hrr	anes
hti	anes
htu	anes
hud	anes
huk	anes
hul	anes
huq	anes
huw	anes
hvk	anes
hvn	anes
iai	anes
iba	anes
ibg	anes
ibl	anes
idt	anes
ifa	anes
ifb	anes
iff	anes
ifk	anes
ifu	anes
ify	anes
ila	anes
ilk	anes
ill	anes
ilo	anes
ilu	anes
ilw	anes
imr	anes
ind	anes
inn	anes
ire	anes
irh	anes
iry	anes
isd	anes
ism	anes
itb	anes
iti	anes
itt	anes
itv	anes
ity	anes
ivb	anes
ivv	anes
iwk	anes
jae	anes
jaj	anes
jak	anes
jal	anes
jas	anes
jau	anes
jav	anes
jax	anes
jaz	anes
jmd	anes
jra	anes
jvn	anes
kae	anes
kag	anes
kak	anes
kbm	anes
kbt	anes
kbw	anes
kcl	anes
kdf	anes
kdk	anes
kei	anes
kem	anes
kgb	anes
kge	anes
kgh	anes
kgx	anes
khc	anes
khl	anes
khz	anes
kij	anes
kis	anes
kjc	anes
kje	anes
kji	anes
kjk	anes
kjr	anes
kkg	anes
kkk	anes
kkv	anes
kkx	anes
klg	anes
kli	anes
kll	anes
klv	anes
klw	anes
klx	anes
kly	anes
kmd	anes
kmk	anes
kml	anes
knb	anes
kne	anes
knh	anes
knl	anes
knx	anes
koa	anes
kod	anes
kos	anes
kpd	anes
kpg	anes
kqe	anes
kqf	anes
kqr	anes
kqt	anes
kqv	anes
kqw	anes
krd	anes
krf	anes
krj	anes
krq	anes
ksc	anes
ksd	anes
kse	anes
ksg	anes
ksl	anes
ksn	anes
ksx	anes
ktk	anes
ktm	anes
ktq	anes
ktr	anes
kud	anes
kuk	anes
kuv	anes
kvb	anes
kvc	anes
kve	anes
kvh	anes
kvo	anes
kvp	anes
kvr	anes
kvv	anes
kwd	anes
kwf	anes
kwh	anes
kxa	anes
kxd	anes
kxg	anes
kxi	anes
kxn	anes
kxr	anes
kyb	anes
kyd	anes
kyi	anes
kyj	anes
kyk	anes
kyn	anes
kys	anes
kzb	anes
kzd	anes
kzf	anes
kzi	anes
kzj	anes
kzl	anes
kzp	anes
kzs	anes
kzt	anes
kzu	anes
kzx	anes
laa	anes
law	anes
laz	anes
lbb	anes
lbq	anes
lbu	anes
lbv	anes
lbw	anes
lbx	anes
lcc	anes
lcd	anes
lce	anes
lcf	anes
lcl	anes
lcm	anes
lcq	anes
lcs	anes
lek	anes
ler	anes
let	anes
leu	anes
lew	anes
lex	anes
ley	anes
lga	anes
lgb	anes
lgi	anes
lgk	anes
lgl	anes
lgr	anes
lgu	anes
lhh	anes
lhn	anes
lht	anes
lib	anes
lid	anes
lih	anes
lio	anes
liw	anes
lix	anes
lje	anes
lji	anes
ljl	anes
ljp	anes
lka	anes
lkj	anes
lkn	anes
lle	anes
llf	anes
llg	anes
llk	anes
llm	anes
llp	anes
llq	anes
llu	anes
llx	anes
lmb	anes
lmf	anes
lmg	anes
lmj	anes
lml	anes
lmq	anes
lmr	anes
lmt	anes
lmu	anes
lmv	anes
lmy	anes
lnd	anes
lnn	anes
lnt	anes
loc	anes
lod	anes
loe	anes
loj	anes
los	anes
low	anes
lox	anes
lpa	anes
lra	anes
lrn	anes
lrv	anes
lti	anes
ltu	anes
lur	anes
lvu	anes
lwe	anes
lwt	anes
lww	anes
lzl	anes
mad	anes
mah	anes
mak	anes
max	anes
mba	anes
mbb	anes
mbd	anes
mbh	anes
mbi	anes
mbk	anes
mbq	anes
mbs	anes
mbt	anes
mcy	anes
mdh	anes
mdr	anes
mee	anes
meg	anes
mek	anes
mel	anes
meo	anes
met	anes
meu	anes
mfa	anes
mfb	anes
mfp	anes
mft	anes
mgl	anes
mgm	anes
mhp	anes
mhs	anes
mhy	anes
mhz	anes
min	anes
mjk	anes
mjm	anes
mkj	anes
mkm	anes
mkt	anes
mkv	anes
mkx	anes
mky	anes
mla	anes
mli	anes
mll	anes
mln	anes
mlu	anes
mlv	anes
mlx	anes
mly	anes
mlz	anes
mme	anes
mmg	anes
mmm	anes
mmn	anes
mmo	anes
mmt	anes
mmw	anes
mmx	anes
mna	anes
mnb	anes
mnl	anes
mnv	anes
mog	anes
mox	anes
mpl	anes
mpn	anes
mpo	anes
mpr	anes
mpx	anes
mpy	anes
mqa	anes
mqc	anes
mqd	anes
mqg	anes
mqi	anes
mqj	anes
mqk	anes
mqm	anes
mqn	anes
mqp	anes
mqq	anes
mqx	anes
mqy	anes
mqz	anes
mrb	anes
mri	anes
mrk	anes
mrl	anes
mrm	anes
mrn	anes
mrp	anes
mrq	anes
mrs	anes
mrv	anes
mrw	anes
mry	anes
msb	anes
msh	anes
msi	anes
msk	anes
msm	anes
msn	anes
msq	anes
mss	anes
mst	anes
msu	anes
mta	anes
mtd	anes
mte	anes
mth	anes
mtt	anes
mtw	anes
mui	anes
mum	anes
mva	anes
mvd	anes
mvn	anes
mvo	anes
mvp	anes
mvr	anes
mvt	anes
mvv	anes
mvx	anes
mwa	anes
mwc	anes
mwg	anes
mwh	anes
mwi	anes
mwo	anes
mwt	anes
mwv	anes
mxd	anes
mxe	anes
mxm	anes
mxr	anes
mxz	anes
myl	anes
myt	anes
myw	anes
mzq	anes
mzz	anes
nae	anes
nak	anes
nal	anes
nau	anes
nbn	anes
ncc	anes
ncf	anes
ncn	anes
nea	anes
nee	anes
nek	anes
nem	anes
nen	anes
nfa	anes
nho	anes
nia	anes
nij	anes
nil	anes
niu	anes
nke	anes
nkk	anes
nkp	anes
nkr	anes
nlg	anes
nmb	anes
nmk	anes
nms	anes
nmt	anes
nmw	anes
nnd	anes
nni	anes
npn	anes
npy	anes
nrg	anes
nrm	anes
nrz	anes
nsn	anes
nss	anes
nsw	anes
nua	anes
nul	anes
num	anes
nuq	anes
nur	anes
nvh	anes
nwi	anes
nxa	anes
nxe	anes
nxg	anes
nxj	anes
nxl	anes
obo	anes
ogn	anes
ojv	anes
omb	anes
oni	anes
onu	anes
ora	anes
orn	anes
ors	anes
orz	anes
osi	anes
otd	anes
oum	anes
oyy	anes
pag	anes
pam	anes
pat	anes
pau	anes
pdn	anes
pdo	anes
pec	anes
pee	anes
pek	anes
pel	anes
pen	anes
pex	anes
pez	anes
pfa	anes
pgk	anes
pif	anes
piv	anes
pix	anes
piz	anes
pkg	anes
pkp	anes
pku	anes
plb	anes
plc	anes
ple	anes
plh	anes
plm	anes
plt	anes
plv	anes
plw	anes
plz	anes
pma	anes
pmc	anes
pme	anes
pmo	anes
pmt	anes
pna	anes
pnc	anes
pne	anes
pnh	anes
pni	anes
pnm	anes
pnp	anes
pns	anes
pon	anes
pop	anes
ppk	anes
ppm	anes
ppn	anes
ppr	anes
ppu	anes
prh	anes
pri	anes
pse	anes
psn	anes
pss	anes
psw	anes
ptn	anes
ptp	anes
ptr	anes
ptt	anes
ptu	anes
ptv	anes
puc	anes
pud	anes
puf	anes
puj	anes
pun	anes
put	anes
puw	anes
pwg	anes
pwm	anes
pwn	anes
pyu	anes
rad	anes
rae	anes
rai	anes
rak	anes
rap	anes
rar	anes
ray	anes
raz	anes
reb	anes
ree	anes
rej	anes
rga	anes
rgs	anes
rgu	anes
rir	anes
riu	anes
rjg	anes
rkh	anes
rmm	anes
rnn	anes
rob	anes
roc	anes
roe	anes
rog	anes
rol	anes
ror	anes
row	anes
rpn	anes
rri	anes
rro	anes
rth	anes
rtm	anes
rug	anes
ruu	anes
rws	anes
sas	anes
sau	anes
sax	anes
sbb	anes
sbc	anes
sbe	anes
sbh	anes
sbl	anes
sbr	anes
sbx	anes
scg	anes
sda	anes
sdd	anes
sdi	anes
sdm	anes
sdo	anes
sdu	anes
sdx	anes
seu	anes
sew	anes
sgb	anes
sge	anes
sgu	anes
sgz	anes
sib	anes
sih	anes
sij	anes
sjb	anes
sjm	anes
sjr	anes
ske	anes
skg	anes
skh	anes
ski	anes
skl	anes
skn	anes
sko	anes
skp	anes
sku	anes
skx	anes
sky	anes
skz	anes
slb	anes
slg	anes
slm	anes
slp	anes
slu	anes
sly	anes
slz	anes
smk	anes
sml	anes
smo	anes
smr	anes
smw	anes
snb	anes
snc	anes
sne	anes
snl	anes
sns	anes
snv	anes
sob	anes
sol	anes
sov	anes
spb	anes
spe	anes
spg	anes
spr	anes
sps	anes
sre	anes
srf	anes
srg	anes
srj	anes
srk	anes
srv	anes
srw	anes
sry	anes
ssb	anes
sse	anes
ssf	anes
ssg	anes
sso	anes
ssq	anes
ssv	anes
ssz	anes
stb	anes
ste	anes
stn	anes
stw	anes
suc	anes
suf	anes
sul	anes
sun	anes
suu	anes
svb	anes
sve	anes
swp	anes
sws	anes
swu	anes
sww	anes
sxn	anes
sxr	anes
sya	anes
syb	anes
szd	anes
szn	anes
szw	anes
tah	anes
tao	anes
tay	anes
tbc	anes
tbe	anes
tbf	anes
tbj	anes
tbk	anes
tbl	anes
tbo	anes
tbw	anes
tbx	anes
tdi	anes
tdj	anes
tdn	anes
tdu	anes
tdx	anes
tdy	anes
tes	anes
tet	anes
tev	anes
tgb	anes
tgc	anes
tgg	anes
tgi	anes
tgl	anes
tgo	anes
tgp	anes
tgq	anes
tgs	anes
tgt	anes
tid	anes
tih	anes
tio	anes
tis	anes
tiu	anes
tiy	anes
tjg	anes
tkd	anes
tkl	anes
tkp	anes
tkw	anes
tld	anes
tlk	anes
tlm	anes
tln	anes
tlr	anes
tls	anes
tlt	anes
tlu	anes
tlv	anes
tlw	anes
tlx	anes
tlz	anes
tmb	anes
tmi	anes
tmn	anes
tmq	anes
tmt	anes
tmw	anes
tmy	anes
tne	anes
tni	anes
tnj	anes
tnk	anes
tnl	anes
tnn	anes
tnp	anes
tns	anes
tnt	anes
tnw	anes
tnx	anes
tom	anes
ton	anes
tox	anes
toy	anes
tpa	anes
tpv	anes
tpz	anes
tql	anes
tqp	anes
trb	anes
tre	anes
trv	anes
trx	anes
tsg	anes
tsr	anes
tsu	anes
tte	anes
ttg	anes
tti	anes
ttp	anes
ttu	anes
ttv	anes
ttw	anes
ttx	anes
tuc	anes
tva	anes
tve	anes
tvk	anes
tvl	anes
tvm	anes
tvw	anes
twb	anes
twp	anes
twu	anes
twy	anes
txa	anes
txe	anes
txm	anes
txn	anes
txq	anes
txs	anes
txx	anes
txy	anes
tzn	anes
ubm	anes
ubr	anes
udj	anes
ues	anes
uge	anes
uli	anes
ulm	anes
umi	anes
ums	anes
una	anes
unz	anes
upv	anes
urk	anes
urn	anes
urr	anes
urv	anes
utp	anes
uun	anes
uur	anes
uve	anes
uvl	anes
val	anes
vao	anes
vbb	anes
viv	anes
vkk	anes
vkl	anes
vko	anes
vkt	anes
vky	anes
vlp	anes
vlr	anes
vme	anes
vmg	anes
vmo	anes
vms	anes
vnk	anes
vnm	anes
vnp	anes
vrs	anes
vrt	anes
wab	anes
wad	anes
wag	anes
wah	anes
war	anes
wat	anes
waz	anes
wbb	anes
wbw	anes
wed	anes
weo	anes
wet	anes
wew	anes
wgo	anes
wgw	anes
wha	anes
whk	anes
whu	anes
wiv	anes
wkd	anes
wlo	anes
wlr	anes
wls	anes
wmh	anes
wmm	anes
wmn	anes
wnk	anes
woc	anes
woe	anes
woo	anes
wow	anes
wrp	anes
wru	anes
wrx	anes
wsi	anes
wtw	anes
wuv	anes
wuy	anes
wwo	anes
wyy	anes
xah	anes
xay	anes
xbr	anes
xdy	anes
xem	anes
xkd	anes
xke	anes
xkl	anes
xkm	anes
xkn	anes
xkq	anes
xks	anes
xkx	anes
xky	anes
xmt	anes
xmv	anes
xmw	anes
xmx	anes
xmz	anes
xnb	anes
xnn	anes
xsb	anes
xsi	anes
xsy	anes
xxk	anes
yap	anes
yka	anes
ykk	anes
ykm	anes
ylu	anes
yly	anes
yml	anes
ymn	anes
ymp	anes
yob	anes
yog	anes
yrs	anes
zbe	anes
zbt	anes
zbw	anes
zeg	anes
zgr	anes
zka	anes
zmi	anes
aru	arau
bnh	arau
cul	arau
dny	arau
jaa	arau
jap	arau
pad	arau
swx	arau
arn	arcn
huh	arcn
atx	arus
spc	arus
aca	arwk
ame	arwk
aox	arwk
apu	arwk
arw	arwk
bae	arwk
brg	arwk
bvv	arwk
bwi	arwk
cab	arwk
caj	arwk
cbb	arwk
ccc	arwk
cjo	arwk
cni	arwk
cot	arwk
cox	arwk
cpb	arwk
cpc	arwk
cpu	arwk
cpy	arwk
crb	arwk
cru	arwk
cuj	arwk
cum	arwk
gae	arwk
gqn	arwk
guc	arwk
ign	arwk
inp	arwk
irn	arwk
kpc	arwk
mcb	arwk
mht	arwk
mmh	arwk
mpd	arwk
mpw	arwk
mzx	arwk
not	arwk
ome	arwk
pab	arwk
paj	arwk
pbg	arwk
pib	arwk
pio	arwk
plu	arwk
pod	arwk
prq	arwk
rgr	arwk
sar	arwk
tae	arwk
tba	arwk
ter	arwk
tnq	arwk
toe	arwk
trn	arwk
unk	arwk
wap	arwk
wau	arwk
xir	arwk
yaw	arwk
ybn	arwk
ycn	arwk
yvt	arwk
ain	asis
bsk	asis
kor	asis
niv	asis
nll	asis
aay	asun
anr	asun
btl	asun
ckh	asun
mld	asun
mmj	asun
mmk	asun
neo	asun
wrd	asun
wxa	asun
aem	ausa
agi	ausa
alk	ausa
aml	ausa
asr	ausa
bbh	ausa
bdq	ausa
bfw	ausa
bgh	ausa
bgk	ausa
bgl	ausa
bix	ausa
biy	ausa
blr	ausa
brb	ausa
bru	ausa
brv	ausa
btq	ausa
bxt	ausa
caq	ausa
cbn	ausa
cdz	ausa
cma	ausa
cmo	ausa
cno	ausa
cog	ausa
crv	ausa
crw	ausa
cua	ausa
cwg	ausa
dnu	ausa
gaq	ausa
gbj	ausa
hal	ausa
hld	ausa
hnu	ausa
hoc	ausa
hre	ausa
huo	ausa
irr	ausa
jah	ausa
jeg	ausa
jeh	ausa
jhi	ausa
jun	ausa
juy	ausa
kdt	ausa
kfj	ausa
kfp	ausa
kfq	ausa
kgc	ausa
kgd	ausa
kha	ausa
khf	ausa
khm	ausa
khr	ausa
kjg	ausa
kjm	ausa
kkn	ausa
knq	ausa
kns	ausa
kpm	ausa
krr	ausa
krv	ausa
ksz	ausa
kta	ausa
ktv	ausa
kuf	ausa
kxm	ausa
kxy	ausa
lbm	ausa
lbn	ausa
lbo	ausa
lcp	ausa
llo	ausa
lmm	ausa
lnh	ausa
lwl	ausa
mhe	ausa
mjx	ausa
mlf	ausa
mml	ausa
mng	ausa
mnn	ausa
mnq	ausa
mnw	ausa
moo	ausa
mqt	ausa
mra	ausa
mtq	ausa
muw	ausa
mzt	ausa
ncb	ausa
nev	ausa
ngt	ausa
nik	ausa
nuo	ausa
nyl	ausa
oog	ausa
oyb	ausa
pac	ausa
pbv	ausa
pcb	ausa
pce	ausa
pcj	ausa
phg	ausa
pkt	ausa
pll	ausa
ply	ausa
pnx	ausa
prb	ausa
prk	ausa
prt	ausa
pry	ausa
puo	ausa
rbb	ausa
ren	ausa
ril	ausa
rka	ausa
rmx	ausa
sat	ausa
sbo	ausa
scb	ausa
scq	ausa
sea	ausa
sed	ausa
sii	ausa
skk	ausa
smu	ausa
spu	ausa
sqq	ausa
srb	ausa
ssm	ausa
sss	ausa
stg	ausa
sti	ausa
stt	ausa
stu	ausa
sxm	ausa
syo	ausa
sza	ausa
szc	ausa
tdf	ausa
tdr	ausa
tea	ausa
tef	ausa
tgr	ausa
thm	ausa
thx	ausa
tkz	ausa
tlq	ausa
tmo	ausa
tnz	ausa
tou	ausa
tpu	ausa
trd	ausa
tth	ausa
tto	ausa
tyh	ausa
uuu	ausa
vie	ausa
wbm	ausa
xao	ausa
xhv	ausa
xkk	ausa
xko	ausa
xnh	ausa
yin	ausa
zng	ausa
adg	aust
adt	aust
aea	aust
aer	aust
aid	aust
alh	aust
aly	aust
amg	aust
amx	aust
amy	aust
amz	aust
ant	aust
aoi	aust
ard	aust
are	aust
awk	aust
ayd	aust
bcj	aust
bck	aust
bdy	aust
bia	aust
bjb	aust
bjd	aust
bjy	aust
bpt	aust
bvr	aust
bxi	aust
bxj	aust
bxn	aust
bym	aust
bzr	aust
dax	aust
dbl	aust
ddj	aust
dgn	aust
dhg	aust
dhl	aust
dhr	aust
dhu	aust
dif	aust
dit	aust
djb	aust
djd	aust
djf	aust
dji	aust
djj	aust
djl	aust
djn	aust
djr	aust
djw	aust
drl	aust
duj	aust
dyb	aust
dyd	aust
dyn	aust
dyy	aust
err	aust
fln	aust
gbb	aust
gbc	aust
gbd	aust
gbu	aust
gcd	aust
gdc	aust
gdh	aust
gdj	aust
ggd	aust
gge	aust
ggk	aust
ggr	aust
gia	aust
giy	aust
gma	aust
gni	aust
gnl	aust
gnn	aust
gnr	aust
gue	aust
guf	aust
gup	aust
gvn	aust
gvy	aust
gwu	aust
gww	aust
gyd	aust
gyf	aust
gyy	aust
ibd	aust
ilg	aust
jao	aust
jay	aust
jig	aust
jng	aust
kba	aust
kbe	aust
kda	aust
kdd	aust
kgl	aust
kgs	aust
kjn	aust
kkp	aust
kky	aust
kld	aust
ktd	aust
ktg	aust
kux	aust
kuy	aust
kvs	aust
lby	aust
lbz	aust
lmc	aust
lnj	aust
lrg	aust
mec	aust
mem	aust
mep	aust
mfr	aust
mhg	aust
mnt	aust
mpb	aust
mpc	aust
mph	aust
mpj	aust
mvl	aust
mwd	aust
mwf	aust
mwp	aust
nad	aust
nam	aust
nay	aust
nbj	aust
nbx	aust
nck	aust
ngk	aust
nhf	aust
nid	aust
nig	aust
nji	aust
nju	aust
nlr	aust
nly	aust
nmp	aust
nmv	aust
nna	aust
nnr	aust
nnv	aust
nny	aust
nrl	aust
nrx	aust
ntj	aust
nug	aust
nuy	aust
nxn	aust
nyh	aust
nys	aust
nyt	aust
nyv	aust
nyx	aust
pii	aust
pit	aust
piu	aust
pjt	aust
pkn	aust
pnv	aust
pnw	aust
pti	aust
rit	aust
rmb	aust
tbh	aust
thd	aust
tiw	aust
tju	aust
typ	aust
ugb	aust
umd	aust
umg	aust
ump	aust
umr	aust
ung	aust
unp	aust
urc	aust
urf	aust
uwa	aust
vka	aust
vku	aust
vma	aust
vmb	aust
vmi	aust
vml	aust
vmu	aust
waq	aust
wbp	aust
wbt	aust
wbv	aust
wdj	aust
wdu	aust
wga	aust
wgg	aust
wgy	aust
wie	aust
wif	aust
wig	aust
wih	aust
wij	aust
wik	aust
wil	aust
wim	aust
wiw	aust
wkw	aust
wlg	aust
wlu	aust
wmb	aust
wmi	aust
wmt	aust
wnd	aust
wnm	aust
woa	aust
wrb	aust
wrg	aust
wrh	aust
wri	aust
wrl	aust
wrm	aust
wrr	aust
wrw	aust
wrz	aust
wua	aust
wub	aust
wur	aust
wux	aust
wwr	aust
wyb	aust
xmh	aust
xmp	aust
xmq	aust
xmu	aust
xmy	aust
xut	aust
yia	aust
yii	aust
yij	aust
yil	aust
yiy	aust
ylr	aust
ynd	aust
yub	aust
ywr	aust
yww	aust
zma	aust
zmc	aust
zmd	aust
zme	aust
zmg	aust
zmj	aust
zmk	aust
zml	aust
zmm	aust
zmr	aust
zmt	aust
zmu	aust
zmv	aust
zmy	aust
znk	aust
ayc	ayma
ayr	ayma
jqr	ayma
ana	barb
bpb	barb
cbi	barb
cof	barb
gum	barb
kwi	barb
ttk	barb
bqe	basq
bsz	basq
eus	basq
xaq	basq
awh	baya
byl	baya
ari	cadd
cad	cadd
kii	cadd
paw	cadd
wic	cadd
cbt	cahu
jeb	cahu
jic	cais
pih	cant
aap	cari
ake	cari
ako	cari
aoc	cari
apy	cari
atr	cari
bkq	cari
car	cari
cbd	cari
ciy	cari
coy	cari
cuo	cari
hix	cari
jru	cari
kbb	cari
kui	cari
mbc	cari
mcg	cari
mch	cari
mzo	cari
pbc	cari
pbh	cari
pev	cari
sik	cari
slj	cari
tmz	cari
tri	cari
txi	cari
waw	cari
way	cari
yar	cari
yup	cari
hvc	caun
len	caun
mom	caun
xin	caun
ite	chaw
orw	chaw
pav	chaw
trz	chaw
xbx	chaw
arh	chib
brn	chib
bzd	chib
cbg	chib
chb	chib
cjp	chib
con	chib
cuk	chib
gut	chib
gym	chib
kog	chib
kvn	chib
mbp	chib
mot	chib
pay	chib
rma	chib
sab	chib
tbn	chib
tfr	chib
tnb	chib
tnd	chib
tuf	chib
alr	chka
ckt	chka
itl	chka
kpy	chka
krk	chka
cmk	chmn
qui	chmn
ans	choc
aoh	choc
bdc	choc
cca	choc
cmi	choc
crf	choc
cto	choc
emp	choc
noa	choc
rna	choc
sja	choc
tdc	choc
ona	chon
teh	chon
boi	chum
chs	chum
crz	chum
inz	chum
obi	chum
puy	chum
veo	chum
tqw	coah
aaf	drav
all	drav
bfq	drav
bfr	drav
bha	drav
brh	drav
brw	drav
cde	drav
daq	drav
emu	drav
fmu	drav
gau	drav
gdb	drav
ggo	drav
gno	drav
hoy	drav
iru	drav
kan	drav
kej	drav
kep	drav
keq	drav
kev	drav
kfa	drav
kfb	drav
kfc	drav
kfd	drav
kfe	drav
kff	drav
kfg	drav
kfh	drav
kfi	drav
kmj	drav
kpb	drav
kru	drav
kwx	drav
kxl	drav
kxu	drav
kxv	drav
mal	drav
mha	drav
mjo	drav
mjp	drav
mjq	drav
mjr	drav
mjt	drav
mju	drav
mjv	drav
mrr	drav
mut	drav
muv	drav
nbg	drav
nit	drav
pcf	drav
pcg	drav
pch	drav
pci	drav
peg	drav
sle	drav
svr	drav
tam	drav
tcx	drav
tcy	drav
tel	drav
ull	drav
url	drav
vis	drav
vmd	drav
wbq	drav
xua	drav
xub	drav
xuj	drav
yea	drav
yeu	drav
mej	ebir
mnx	ebir
mtj	ebir
anz	epap
ata	epap
blb	epap
buo	epap
byx	epap
ckr	epap
drr	epap
eiv	epap
gcc	epap
gli	epap
kjx	epap
kol	epap
kqj	epap
kto	epap
kyx	epap
kzk	epap
lni	epap
lvk	epap
nas	epap
nco	epap
nfl	epap
ngr	epap
oue	epap
roo	epap
siw	epap
smg	epap
smz	epap
stc	epap
sua	epap
svs	epap
tqu	epap
tuh	epap
uis	epap
uro	epap
yle	epap
zmh	epap
ale	eska
ems	eska
esi	eska
esk	eska
ess	eska
esu	eska
ike	eska
ikt	eska
kal	eska
ynk	eska
ysr	eska
pld	euun
quq	euun
trl	euun
afz	geba
awr	geba
bpo	geba
bqq	geba
brp	geba
bti	geba
bvz	geba
dbf	geba
dei	geba
duv	geba
ert	geba
fau	geba
flh	geba
kiy	geba
kkb	geba
kpi	geba
njs	geba
pas	geba
rac	geba
spi	geba
srt	geba
swr	geba
tad	geba
tbp	geba
tcq	geba
tds	geba
tfo	geba
tmu	geba
trt	geba
tty	geba
wbe	geba
wor	geba
yva	geba
cui	guah
gob	guah
guh	guah
guo	guah
mbn	guah
aqp	gulf
ctm	gulf
ncz	gulf
tun	gulf
amr	hara
hug	hara
cht	hibi
hib	hibi
bje	hmom
blu	hmom
bmt	hmom
bpn	hmom
buh	hmom
bwn	hmom
bwx	hmom
hea	hmom
hma	hmom
hmc	hmom
hmd	hmom
hme	hmom
hmf	hmom
hmg	hmom
hmh	hmom
hmi	hmom
hmj	hmom
hml	hmom
hmm	hmom
hmp	hmom
hmq	hmom
hms	hmom
hmv	hmom
hmw	hmom
hmy	hmom
hmz	hmom
huj	hmom
ium	hmom
mji	hmom
mmr	hmom
muq	hmom
mww	hmom
pha	hmom
pnu	hmom
shx	hmom
acv	hoka
atw	hoka
chd	hoka
cid	hoka
clo	hoka
coc	hoka
coj	hoka
dih	hoka
esq	hoka
kju	hoka
klb	hoka
kyh	hoka
mov	hoka
mrc	hoka
peb	hoka
pef	hoka
pej	hoka
peq	hoka
pom	hoka
poo	hoka
ppi	hoka
sei	hoka
sht	hoka
sln	hoka
was	hoka
ynn	hoka
yuf	hoka
yum	hoka
hue	huav
huv	huav
hve	huav
hvv	huav
aae	ieur
aat	ieur
act	ieur
aee	ieur
aeq	ieur
afr	ieur
ahr	ieur
aiq	ieur
aln	ieur
als	ieur
anp	ieur
arg	ieur
ask	ieur
asm	ieur
ast	ieur
atn	ieur
auv	ieur
avd	ieur
ave	ieur
awa	ieur
bar	ieur
bcc	ieur
bdv	ieur
bdz	ieur
bel	ieur
ben	ieur
bfb	ieur
bfy	ieur
bfz	ieur
bgc	ieur
bgd	ieur
bge	ieur
bgn	ieur
bgp	ieur
bgq	ieur
bgw	ieur
bhb	ieur
bhd	ieur
bhe	ieur
bhh	ieur
bhi	ieur
bho	ieur
bht	ieur
bhu	ieur
bhx	ieur
bjj	ieur
bjm	ieur
bkk	ieur
bmj	ieur
bns	ieur
bos	ieur
bpx	ieur
bpy	ieur
bqi	ieur
bra	ieur
bre	ieur
bsg	ieur
bsh	ieur
btv	ieur
bul	ieur
cat	ieur
ccp	ieur
cdg	ieur
cdh	ieur
cdi	ieur
cdj	ieur
ces	ieur
chu	ieur
cih	ieur
cim	ieur
cit	ieur
ckb	ieur
clh	ieur
cor	ieur
cos	ieur
cpg	ieur
csb	ieur
cym	ieur
czk	ieur
dan	ieur
dcc	ieur
def	ieur
deh	ieur
deu	ieur
dgo	ieur
dgu	ieur
dha	ieur
dhd	ieur
dhn	ieur
dho	ieur
dhw	ieur
diq	ieur
div	ieur
dlc	ieur
dlm	ieur
dmk	ieur
dml	ieur
drt	ieur
drw	ieur
dry	ieur
dsb	ieur
dso	ieur
dub	ieur
duh	ieur
ell	ieur
eml	ieur
eng	ieur
esh	ieur
ext	ieur
fao	ieur
fax	ieur
fay	ieur
faz	ieur
fra	ieur
frc	ieur
fri	ieur
frk	ieur
frp	ieur
frr	ieur
frs	ieur
fur	ieur
gas	ieur
gbk	ieur
gbl	ieur
gbm	ieur
gbz	ieur
gct	ieur
gda	ieur
gdx	ieur
geh	ieur
ggg	ieur
ghc	ieur
ghr	ieur
gig	ieur
gjk	ieur
gju	ieur
gla	ieur
gle	ieur
glg	ieur
glh	ieur
glk	ieur
glv	ieur
goj	ieur
gok	ieur
gom	ieur
gos	ieur
got	ieur
goz	ieur
gra	ieur
grc	ieur
gsc	ieur
gsw	ieur
guj	ieur
gwc	ieur
gwf	ieur
gwt	ieur
gzi	ieur
hac	ieur
haj	ieur
haz	ieur
hif	ieur
hii	ieur
hin	ieur
hlb	ieur
hnd	ieur
hne	ieur
hno	ieur
hns	ieur
hoj	ieur
hrv	ieur
hrz	ieur
hsb	ieur
hye	ieur
isl	ieur
ist	ieur
ita	ieur
itk	ieur
jat	ieur
jdg	ieur
jdt	ieur
jmk	ieur
jml	ieur
jnd	ieur
jns	ieur
jpr	ieur
jut	ieur
kas	ieur
kbu	ieur
kex	ieur
key	ieur
kfm	ieur
kfr	ieur
kfs	ieur
kft	ieur
kfu	ieur
kfv	ieur
kfx	ieur
kfy	ieur
kgn	ieur
khn	ieur
khw	ieur
kiu	ieur
kjf	ieur
kjo	ieur
kls	ieur
kmr	ieur
knn	ieur
kra	ieur
ksh	ieur
ksy	ieur
ktl	ieur
kvx	ieur
kxp	ieur
kyv	ieur
kyw	ieur
lad	ieur
lat	ieur
lav	ieur
lhl	ieur
lij	ieur
lim	ieur
lit	ieur
lki	ieur
lld	ieur
lmn	ieur
lmo	ieur
lms	ieur
lnc	ieur
lrc	ieur
lrk	ieur
lrl	ieur
lsa	ieur
lss	ieur
ltz	ieur
luv	ieur
luz	ieur
mag	ieur
mai	ieur
mar	ieur
mby	ieur
mhn	ieur
mjl	ieur
mjz	ieur
mkb	ieur
mkd	ieur
mke	ieur
mki	ieur
mnj	ieur
mtr	ieur
mup	ieur
mve	ieur
mvy	ieur
mwl	ieur
mxi	ieur
myi	ieur
mzn	ieur
nap	ieur
nds	ieur
nep	ieur
nhh	ieur
nld	ieur
nli	ieur
nlx	ieur
nno	ieur
nob	ieur
noe	ieur
noi	ieur
nrn	ieur
ntz	ieur
nyq	ieur
odk	ieur
okh	ieur
ori	ieur
ort	ieur
oru	ieur
oss	ieur
pan	ieur
paq	ieur
pbt	ieur
pbu	ieur
pcd	ieur
pcl	ieur
pdc	ieur
pdt	ieur
pes	ieur
pfl	ieur
pgg	ieur
phd	ieur
phl	ieur
phr	ieur
phv	ieur
pli	ieur
plk	ieur
plp	ieur
pms	ieur
pmu	ieur
pnb	ieur
pnt	ieur
pol	ieur
por	ieur
pox	ieur
prc	ieur
prd	ieur
prg	ieur
prn	ieur
prp	ieur
prs	ieur
prv	ieur
psh	ieur
psi	ieur
pst	ieur
pwr	ieur
rat	ieur
rdb	ieur
rei	ieur
rge	ieur
rjb	ieur
rmc	ieur
rmf	ieur
rml	ieur
rmn	ieur
rmo	ieur
rmt	ieur
rmw	ieur
rmy	ieur
roh	ieur
ron	ieur
rtw	ieur
rue	ieur
ruo	ieur
rup	ieur
ruq	ieur
rus	ieur
rwr	ieur
san	ieur
saz	ieur
sbn	ieur
sck	ieur
scl	ieur
scn	ieur
sco	ieur
scy	ieur
sdb	ieur
sdc	ieur
sdf	ieur
sdg	ieur
sdh	ieur
sdn	ieur
sdr	ieur
sdt	ieur
sdz	ieur
sgh	ieur
sgl	ieur
sgr	ieur
shm	ieur
sin	ieur
siy	ieur
sjp	ieur
skr	ieur
sli	ieur
slk	ieur
slv	ieur
smm	ieur
smv	ieur
smy	ieur
snd	ieur
soi	ieur
soj	ieur
spa	ieur
spq	ieur
sqo	ieur
src	ieur
srh	ieur
sro	ieur
srp	ieur
srx	ieur
srz	ieur
ssi	ieur
stl	ieur
stq	ieur
sts	ieur
swe	ieur
swg	ieur
swv	ieur
sxu	ieur
syl	ieur
tdb	ieur
tgk	ieur
the	ieur
thl	ieur
thq	ieur
thr	ieur
tkb	ieur
tks	ieur
tkt	ieur
tly	ieur
tnf	ieur
tnv	ieur
tov	ieur
tpe	ieur
tra	ieur
trm	ieur
trw	ieur
tsd	ieur
ttt	ieur
twd	ieur
ukr	ieur
urd	ieur
ush	ieur
usi	ieur
vaa	ieur
vaf	ieur
vah	ieur
vas	ieur
vav	ieur
vec	ieur
ved	ieur
vel	ieur
vgr	ieur
vls	ieur
vmf	ieur
vmh	ieur
wae	ieur
wbk	ieur
wbl	ieur
wbr	ieur
wep	ieur
wln	ieur
wne	ieur
wry	ieur
wsv	ieur
wtm	ieur
xhe	ieur
xka	ieur
xkc	ieur
xkj	ieur
xkp	ieur
xnr	ieur
xvi	ieur
yah	ieur
yai	ieur
ydd	ieur
ydg	ieur
yej	ieur
yib	ieur
yih	ieur
zea	ieur
zrg	ieur
zrp	ieur
zum	ieur
cay	iroq
chr	iroq
lre	iroq
moh	iroq
ntw	iroq
one	iroq
ono	iroq
see	iroq
sqn	iroq
tus	iroq
wya	iroq
ams	japo
jpn	japo
kzg	japo
mvi	japo
okn	japo
ryn	japo
rys	japo
ryu	japo
tkn	japo
xug	japo
yoi	japo
yox	japo
acu	jiva
agr	jiva
hub	jiva
jiv	jiva
jge	kart
kat	kart
lzz	kart
sva	kart
xmf	kart
kav	katk
knm	katk
xat	katk
kee	kere
kjq	kere
aue	khoi
gnk	khoi
gwj	khoi
hgm	khoi
hio	khoi
hnh	khoi
hts	khoi
huc	khoi
knw	khoi
kqu	khoi
kqz	khoi
ktz	khoi
kwz	khoi
mwj	khoi
naq	khoi
ngh	khoi
nhr	khoi
nmn	khoi
oun	khoi
sad	khoi
shg	khoi
tyu	khoi
vaj	khoi
xam	khoi
xeg	khoi
xii	khoi
xuu	khoi
kio	kita
pie	kita
tew	kita
tix	kita
tow	kita
twf	kita
bbf	kwba
bio	kwba
fqs	kwba
grx	kwba
kwo	kwba
pby	kwba
amm	lema
bpw	lema
itr	lema
nax	lema
niw	lema
owi	lema
wsa	lmam
yki	lmam
vil	luvi
apn	macg
ark	macg
bor	macg
cax	macg
fun	macg
gta	macg
gvp	macg
jbt	macg
kgp	macg
kpj	macg
kqq	macg
kre	macg
mbl	macg
opy	macg
oti	macg
prr	macg
ram	macg
rkb	macg
suy	macg
txu	macg
umo	macg
vkm	macg
xav	macg
xer	macg
xkr	macg
xok	macg
xra	macg
xre	macg
xri	macg
zkp	macg
cbv	maku
jup	maku
kwa	maku
mbj	maku
mbr	maku
yab	maku
emo	masc
gva	masc
leg	masc
sap	masc
tmf	masc
acc	maya
acr	maya
agu	maya
caa	maya
cac	maya
cak	maya
cbm	maya
chf	maya
ckc	maya
ckd	maya
cke	maya
ckf	maya
cki	maya
ckj	maya
ckk	maya
ckw	maya
cnm	maya
cob	maya
cti	maya
ctu	maya
cun	maya
hsf	maya
hus	maya
hva	maya
itz	maya
ixi	maya
ixj	maya
ixl	maya
jac	maya
jai	maya
kek	maya
kjb	maya
knj	maya
lac	maya
mam	maya
mhc	maya
mms	maya
mop	maya
mpf	maya
mtz	maya
mvc	maya
mvj	maya
poa	maya
pob	maya
poc	maya
poh	maya
pou	maya
qma	maya
quc	maya
quj	maya
qum	maya
qut	maya
quu	maya
quv	maya
qxi	maya
toj	maya
ttc	maya
tzb	maya
tzc	maya
tze	maya
tzh	maya
tzj	maya
tzo	maya
tzs	maya
tzt	maya
tzu	maya
tzz	maya
usp	maya
yua	maya
yus	maya
axb	mgua
cag	mgua
crq	mgua
crt	mgua
kbc	mgua
mca	mgua
moc	mgua
mtp	mgua
mzh	mgua
plg	mgua
tob	mgua
wlv	mgua
ccr	misu
miq	misu
mtn	misu
sum	misu
mco	mizo
mir	mizo
mto	mizo
mxp	mizo
mxq	mizo
mzl	mizo
neq	mizo
plo	mizo
poi	mizo
poq	mizo
pos	mizo
pxm	mizo
zoc	mizo
zoh	mizo
zoq	mizo
zor	mizo
zos	mizo
myp	mura
akz	musk
cho	musk
cic	musk
cku	musk
mik	musk
mus	musk
aht	nadn
apj	nadn
apk	nadn
apl	nadn
apm	nadn
apw	nadn
bcr	nadn
bea	nadn
caf	nadn
chp	nadn
clc	nadn
coq	nadn
crx	nadn
ctc	nadn
dgr	nadn
eya	nadn
gce	nadn
gwi	nadn
haa	nadn
hax	nadn
hdn	nadn
hoi	nadn
hup	nadn
ing	nadn
kkz	nadn
koy	nadn
ktw	nadn
kuu	nadn
mvb	nadn
nav	nadn
scs	nadn
sek	nadn
srs	nadn
taa	nadn
tau	nadn
tcb	nadn
tce	nadn
tfn	nadn
tgx	nadn
tht	nadn
tli	nadn
tol	nadn
ttm	nadn
tuu	nadn
txc	nadn
wlk	nadn
xsl	nadn
kut	nais
yuc	nais
zun	nais
mbg	namb
nab	namb
sae	namb
wmd	namb
xtw	namb
aex	naun
beo	naun
abk	ncau
abq	ncau
ady	ncau
agx	ncau
akv	ncau
ani	ncau
aqc	ncau
ava	ncau
bbl	ncau
bdk	ncau
bph	ncau
che	ncau
cji	ncau
dar	ncau
ddo	ncau
gdo	ncau
gin	ncau
huz	ncau
inh	ncau
kap	ncau
kbd	ncau
khv	ncau
kjj	ncau
kpt	ncau
kry	ncau
kva	ncau
lbe	ncau
lez	ncau
rut	ncau
tab	ncau
tin	ncau
tkr	ncau
uby	ncau
udi	ncau
aaa	ncon
aab	ncon
aba	ncon
abb	ncon
abi	ncon
abm	ncon
abn	ncon
abo	ncon
abr	ncon
abu	ncon
acb	ncon
acd	ncon
acp	ncon
acz	ncon
ada	ncon
add	ncon
ade	ncon
adj	ncon
adq	ncon
adu	ncon
ael	ncon
afe	ncon
afn	ncon
afo	ncon
afu	ncon
agb	ncon
agc	ncon
agh	ncon
agq	ncon
ags	ncon
aha	ncon
ahi	ncon
ahl	ncon
ahm	ncon
ahn	ncon
ahp	ncon
ahs	ncon
aik	ncon
aiy	ncon
ajg	ncon
aka	ncon
akd	ncon
akf	ncon
akp	ncon
aks	ncon
aku	ncon
akw	ncon
ala	ncon
ald	ncon
alf	ncon
amb	ncon
amo	ncon
anf	ncon
ann	ncon
anv	ncon
anw	ncon
any	ncon
aqg	ncon
asa	ncon
asg	ncon
asj	ncon
ass	ncon
atg	ncon
ati	ncon
ato	ncon
aug	ncon
auh	ncon
aum	ncon
avi	ncon
avn	ncon
awc	ncon
awo	ncon
axk	ncon
ayb	ncon
aye	ncon
ayg	ncon
ayi	ncon
ayk	ncon
ayu	ncon
azo	ncon
bab	ncon
baf	ncon
bag	ncon
bam	ncon
bas	ncon
bau	ncon
bav	ncon
baw	ncon
bax	ncon
baz	ncon
bba	ncon
bbe	ncon
bbg	ncon
bbi	ncon
bbj	ncon
bbk	ncon
bbm	ncon
bbo	ncon
bbp	ncon
bbq	ncon
bbs	ncon
bbu	ncon
bbw	ncon
bbx	ncon
bby	ncon
bcb	ncon
bce	ncon
bcg	ncon
bci	ncon
bcn	ncon
bcp	ncon
bcs	ncon
bcv	ncon
bcz	ncon
bda	ncon
bdj	ncon
bdp	ncon
bdt	ncon
bdu	ncon
beb	ncon
bec	ncon
beh	ncon
bem	ncon
beq	ncon
bes	ncon
bet	ncon
bev	ncon
bez	ncon
bfd	ncon
bff	ncon
bfj	ncon
bfl	ncon
bfm	ncon
bfo	ncon
bfp	ncon
bga	ncon
bgf	ncon
bgj	ncon
bgm	ncon
bgo	ncon
bgu	ncon
bhy	ncon
bib	ncon
bif	ncon
bij	ncon
bil	ncon
bim	ncon
bin	ncon
bip	ncon
biv	ncon
biw	ncon
biz	ncon
bja	ncon
bjg	ncon
bjo	ncon
bjt	ncon
bju	ncon
bjw	ncon
bka	ncon
bkc	ncon
bkf	ncon
bkg	ncon
bkh	ncon
bkj	ncon
bkm	ncon
bko	ncon
bkp	ncon
bkt	ncon
bkv	ncon
bkw	ncon
bky	ncon
ble	ncon
blh	ncon
bli	ncon
blo	ncon
blv	ncon
bly	ncon
bma	ncon
bmb	ncon
bmd	ncon
bme	ncon
bmf	ncon
bmg	ncon
bml	ncon
bmo	ncon
bmq	ncon
bmv	ncon
bmw	ncon
bmy	ncon
bng	ncon
bni	ncon
bnm	ncon
bnx	ncon
bnz	ncon
boe	ncon
bof	ncon
boh	ncon
bok	ncon
bom	ncon
boo	ncon
bou	ncon
bov	ncon
box	ncon
boy	ncon
boz	ncon
bpd	ncon
bpj	ncon
bqa	ncon
bqc	ncon
bqf	ncon
bqg	ncon
bqj	ncon
bqk	ncon
bqm	ncon
bqo	ncon
bqp	ncon
bqt	ncon
bqu	ncon
bqv	ncon
bqw	ncon
bqx	ncon
bqz	ncon
brf	ncon
bri	ncon
brl	ncon
brm	ncon
brt	ncon
bsc	ncon
bse	ncon
bsf	ncon
bsi	ncon
bsj	ncon
bsl	ncon
bsp	ncon
bsq	ncon
bsr	ncon
bss	ncon
bsv	ncon
bsx	ncon
btb	ncon
btc	ncon
bte	ncon
btg	ncon
btt	ncon
btu	ncon
bub	ncon
bud	ncon
buf	ncon
bui	ncon
buj	ncon
bum	ncon
bun	ncon
bus	ncon
buu	ncon
buw	ncon
buy	ncon
buz	ncon
bvb	ncon
bvg	ncon
bvi	ncon
bvj	ncon
bvm	ncon
bvo	ncon
bvx	ncon
bwc	ncon
bwg	ncon
bwh	ncon
bwj	ncon
bwl	ncon
bwq	ncon
bws	ncon
bwt	ncon
bwu	ncon
bww	ncon
bwy	ncon
bwz	ncon
bxc	ncon
bxg	ncon
bxk	ncon
bxl	ncon
bxp	ncon
bxs	ncon
bxw	ncon
bxx	ncon
byb	ncon
byc	ncon
byf	ncon
byi	ncon
byj	ncon
byp	ncon
bys	ncon
byv	ncon
byy	ncon
bza	ncon
bze	ncon
bzm	ncon
bzo	ncon
bzv	ncon
bzw	ncon
bzx	ncon
bzy	ncon
bzz	ncon
cae	ncon
cbj	ncon
cbo	ncon
cce	ncon
ccg	ncon
cch	ncon
ccj	ncon
cdr	ncon
cfa	ncon
cfd	ncon
cfg	ncon
cgg	ncon
chw	ncon
cib	ncon
cjk	ncon
cko	ncon
ckx	ncon
cli	ncon
cll	ncon
cme	ncon
coh	ncon
cou	ncon
cpn	ncon
cry	ncon
csk	ncon
cug	ncon
cuh	ncon
cwa	ncon
cwb	ncon
cwe	ncon
cwt	ncon
dae	ncon
daf	ncon
dag	ncon
dai	ncon
das	ncon
dav	ncon
dba	ncon
dbd	ncon
dbg	ncon
dbi	ncon
dbm	ncon
dbo	ncon
dbu	ncon
dbv	ncon
dde	ncon
dds	ncon
dec	ncon
dee	ncon
deg	ncon
dek	ncon
deq	ncon
dez	ncon
dga	ncon
dgd	ncon
dgi	ncon
dgs	ncon
dhm	ncon
dhs	ncon
dic	ncon
dig	ncon
dii	ncon
dio	ncon
dir	ncon
diu	ncon
diz	ncon
djm	ncon
dkl	ncon
dma	ncon
dmm	ncon
dmo	ncon
dmx	ncon
dne	ncon
dnn	ncon
doe	ncon
doh	ncon
doo	ncon
dop	ncon
dos	ncon
dov	ncon
dow	ncon
doy	ncon
dri	ncon
dtk	ncon
dtm	ncon
dts	ncon
dtt	ncon
dua	ncon
dud	ncon
dug	ncon
dur	ncon
dux	ncon
duz	ncon
dya	ncon
dyi	ncon
dyo	ncon
dyu	ncon
dza	ncon
dzn	ncon
ebg	ncon
ebo	ncon
ebr	ncon
ebu	ncon
efa	ncon
efi	ncon
ega	ncon
ego	ncon
ehu	ncon
eja	ncon
eka	ncon
eke	ncon
eki	ncon
ekm	ncon
eko	ncon
ekp	ncon
ekr	ncon
eli	ncon
elm	ncon
ema	ncon
emk	ncon
emn	ncon
enn	ncon
env	ncon
enw	ncon
eot	ncon
epi	ncon
erh	ncon
esm	ncon
etb	ncon
eto	ncon
ets	ncon
etu	ncon
etx	ncon
evh	ncon
ewe	ncon
ewo	ncon
eze	ncon
fah	ncon
fak	ncon
fal	ncon
fam	ncon
fan	ncon
fap	ncon
fer	ncon
ffm	ncon
fip	ncon
fir	ncon
fiz	ncon
fll	ncon
flr	ncon
fmp	ncon
fni	ncon
fod	ncon
fom	ncon
fon	ncon
fub	ncon
fuc	ncon
fue	ncon
fuf	ncon
fuh	ncon
fui	ncon
fuj	ncon
fum	ncon
fuq	ncon
fuv	ncon
fwe	ncon
gaa	ncon
gbg	ncon
gbh	ncon
gbo	ncon
gbp	ncon
gbq	ncon
gbr	ncon
gbs	ncon
gbv	ncon
gbx	ncon
gby	ncon
gdi	ncon
gec	ncon
ged	ncon
geg	ncon
gej	ncon
gel	ncon
geq	ncon
gey	ncon
ggb	ncon
ggu	ncon
gix	ncon
gjn	ncon
gke	ncon
gkn	ncon
gkp	ncon
glc	ncon
glj	ncon
glr	ncon
gmd	ncon
gmm	ncon
gmn	ncon
gmx	ncon
gna	ncon
gne	ncon
gng	ncon
gnh	ncon
gnz	ncon
goa	ncon
god	ncon
gog	ncon
gol	ncon
gox	ncon
goy	ncon
gpa	ncon
grh	ncon
grj	ncon
grv	ncon
gry	ncon
gsl	ncon
gti	ncon
gua	ncon
gud	ncon
gur	ncon
guv	ncon
guw	ncon
gux	ncon
guz	ncon
gvm	ncon
gwa	ncon
gwb	ncon
gwe	ncon
gwg	ncon
gwr	ncon
gwx	ncon
gxx	ncon
gya	ncon
gye	ncon
gyg	ncon
gyi	ncon
hag	ncon
han	ncon
haq	ncon
hav	ncon
hay	ncon
hba	ncon
hbn	ncon
heh	ncon
hem	ncon
her	ncon
hhr	ncon
hij	ncon
hka	ncon
hke	ncon
hoe	ncon
hol	ncon
hom	ncon
hoo	ncon
hum	ncon
hwa	ncon
ibb	ncon
ibe	ncon
ibi	ncon
ibm	ncon
ibn	ncon
ibo	ncon
ibr	ncon
iby	ncon
ica	ncon
ich	ncon
ida	ncon
idc	ncon
idd	ncon
ide	ncon
idr	ncon
ids	ncon
idu	ncon
ife	ncon
ifm	ncon
igb	ncon
ige	ncon
igl	ncon
igw	ncon
ihi	ncon
ijc	ncon
ije	ncon
ijj	ncon
ijn	ncon
ijs	ncon
iki	ncon
ikk	ncon
ikl	ncon
iko	ncon
ikp	ncon
ikv	ncon
ikw	ncon
ikz	ncon
ilb	ncon
ilv	ncon
iri	ncon
ish	ncon
isi	ncon
isn	ncon
iso	ncon
isu	ncon
itm	ncon
its	ncon
itw	ncon
iya	ncon
iyo	ncon
iyx	ncon
izi	ncon
jab	ncon
jad	ncon
jar	ncon
jbu	ncon
jek	ncon
jen	ncon
jer	ncon
jgb	ncon
jgo	ncon
jib	ncon
jid	ncon
jit	ncon
jku	ncon
jle	ncon
jmc	ncon
jmr	ncon
jms	ncon
jni	ncon
job	ncon
jod	ncon
jow	ncon
jrr	ncon
jub	ncon
jud	ncon
juh	ncon
juk	ncon
juo	ncon
juw	ncon
jwi	ncon
kad	ncon
kaj	ncon
kam	ncon
kao	ncon
kbj	ncon
kbn	ncon
kbp	ncon
kbs	ncon
kcc	ncon
kce	ncon
kcf	ncon
kcg	ncon
kch	ncon
kci	ncon
kcj	ncon
kck	ncon
kcq	ncon
kcr	ncon
kcu	ncon
kcv	ncon
kcw	ncon
kcz	ncon
kdc	ncon
kde	ncon
kdg	ncon
kdh	ncon
kdl	ncon
kdm	ncon
kdn	ncon
kdp	ncon
kdx	ncon
kdz	ncon
keb	ncon
ked	ncon
kef	ncon
kel	ncon
ken	ncon
kes	ncon
keu	ncon
kez	ncon
kfl	ncon
kfn	ncon
kfo	ncon
kfz	ncon
kga	ncon
kgt	ncon
khj	ncon
khu	ncon
khx	ncon
khy	ncon
kia	ncon
kib	ncon
kid	ncon
kik	ncon
kin	ncon
kiv	ncon
kiz	ncon
kka	ncon
kkd	ncon
kke	ncon
kki	ncon
kkj	ncon
kkm	ncon
kkq	ncon
kku	ncon
kkw	ncon
klc	ncon
klk	ncon
klo	ncon
klu	ncon
kma	ncon
kmb	ncon
kme	ncon
kmi	ncon
kmp	ncon
kmw	ncon
kmy	ncon
knf	ncon
kng	ncon
kni	ncon
knk	ncon
kno	ncon
knp	ncon
knu	ncon
kny	ncon
knz	ncon
koc	ncon
koh	ncon
koo	ncon
koq	ncon
kou	ncon
kov	ncon
kow	ncon
kph	ncon
kpk	ncon
kpl	ncon
kpo	ncon
kqg	ncon
kqk	ncon
kqm	ncon
kqn	ncon
kqo	ncon
kqs	ncon
krh	ncon
krm	ncon
krn	ncon
krp	ncon
krw	ncon
krx	ncon
ksa	ncon
ksb	ncon
ksf	ncon
ksm	ncon
kss	ncon
kst	ncon
ksv	ncon
ktf	ncon
ktj	ncon
kty	ncon
kua	ncon
kub	ncon
kug	ncon
kuj	ncon
kus	ncon
kuw	ncon
kvm	ncon
kwb	ncon
kwc	ncon
kwm	ncon
kwn	ncon
kwp	ncon
kwq	ncon
kws	ncon
kwu	ncon
kwy	ncon
kxb	ncon
kxe	ncon
kxx	ncon
kya	ncon
kye	ncon
kyf	ncon
kym	ncon
kza	ncon
kzc	ncon
kzn	ncon
kzo	ncon
kzr	ncon
kzy	ncon
laf	ncon
lag	ncon
lai	ncon
lak	ncon
lal	ncon
lam	ncon
lan	ncon
lar	ncon
las	ncon
lbi	ncon
lch	ncon
ldb	ncon
ldg	ncon
ldh	ncon
ldi	ncon
ldj	ncon
ldk	ncon
ldl	ncon
ldm	ncon
ldo	ncon
ldp	ncon
lea	ncon
leb	ncon
lee	ncon
lef	ncon
leh	ncon
lej	ncon
lel	ncon
lem	ncon
leo	ncon
lfa	ncon
lgm	ncon
lgq	ncon
lgz	ncon
lia	ncon
lie	ncon
lig	ncon
lik	ncon
lin	ncon
lip	ncon
liy	ncon
liz	ncon
lke	ncon
lla	ncon
llb	ncon
llc	ncon
lli	ncon
lma	ncon
lmd	ncon
lmp	ncon
lmx	ncon
lna	ncon
lnb	ncon
lnl	ncon
lns	ncon
lnu	ncon
lnz	ncon
lob	ncon
lof	ncon
loi	ncon
lok	ncon
lol	ncon
lom	ncon
loo	ncon
lop	ncon
loq	ncon
lor	ncon
loz	ncon
lro	ncon
lse	ncon
lua	ncon
lub	ncon
lue	ncon
lug	ncon
luj	ncon
lum	ncon
lun	ncon
lup	ncon
luq	ncon
luy	ncon
lwa	ncon
lyn	ncon
mae	ncon
maw	ncon
mbm	ncon
mbo	ncon
mbu	ncon
mbv	ncon
mcj	ncon
mck	ncon
mcp	ncon
mcs	ncon
mct	ncon
mcu	ncon
mcx	ncon
mda	ncon
mdd	ncon
mdm	ncon
mdn	ncon
mdo	ncon
mdp	ncon
mdq	ncon
mdt	ncon
mdu	ncon
mdw	ncon
mea	ncon
men	ncon
mer	ncon
mev	ncon
mfc	ncon
mfd	ncon
mff	ncon
mfg	ncon
mfn	ncon
mfo	ncon
mfq	ncon
mfu	ncon
mfv	ncon
mgg	ncon
mgh	ncon
mgi	ncon
mgj	ncon
mgn	ncon
mgo	ncon
mgq	ncon
mgr	ncon
mgs	ncon
mgv	ncon
mgw	ncon
mgy	ncon
mgz	ncon
mhb	ncon
mhk	ncon
mhm	ncon
mho	ncon
mhw	ncon
mij	ncon
mjh	ncon
mka	ncon
mkk	ncon
mkl	ncon
mko	ncon
mku	ncon
mlb	ncon
mlk	ncon
mlo	ncon
mlq	ncon
mma	ncon
mmu	ncon
mmz	ncon
mnf	ncon
mnh	ncon
mnk	ncon
mny	ncon
moa	ncon
moi	ncon
moj	ncon
mor	ncon
mos	ncon
mow	ncon
mpa	ncon
mql	ncon
mru	ncon
msc	ncon
msj	ncon
msw	ncon
mtb	ncon
mtk	ncon
mua	ncon
muc	ncon
muh	ncon
muo	ncon
mvw	ncon
mwe	ncon
mwk	ncon
mwn	ncon
mws	ncon
mwz	ncon
mxc	ncon
mxg	ncon
mxl	ncon
mxo	ncon
mxx	ncon
myc	ncon
mye	ncon
myg	ncon
myj	ncon
myk	ncon
myq	ncon
myx	ncon
mzd	ncon
mzj	ncon
mzk	ncon
mzm	ncon
mzv	ncon
mzw	ncon
naj	ncon
nar	ncon
nat	ncon
naw	ncon
nba	ncon
nbb	ncon
nbd	ncon
nbl	ncon
nbm	ncon
nbo	ncon
nbp	ncon
nbr	ncon
nbv	ncon
nbw	ncon
ncp	ncon
ncr	ncon
ncu	ncon
nda	ncon
ndb	ncon
ndc	ncon
ndd	ncon
nde	ncon
ndg	ncon
ndh	ncon
ndi	ncon
ndj	ncon
ndk	ncon
ndl	ncon
ndn	ncon
ndo	ncon
ndq	ncon
ndr	ncon
ndt	ncon
ndu	ncon
ndv	ncon
ndw	ncon
ndz	ncon
neb	ncon
ned	ncon
ney	ncon
nfd	ncon
nfg	ncon
nfk	ncon
nfr	ncon
nfu	ncon
nga	ncon
ngb	ncon
ngc	ncon
ngd	ncon
nge	ncon
ngg	ncon
ngj	ncon
ngl	ncon
ngn	ncon
ngo	ncon
ngp	ncon
ngq	ncon
ngv	ncon
ngy	ncon
ngz	ncon
nhb	ncon
nhu	ncon
nie	ncon
nih	ncon
nim	ncon
nin	ncon
nix	ncon
njd	ncon
njj	ncon
njr	ncon
njx	ncon
njy	ncon
nka	ncon
nkc	ncon
nkn	ncon
nko	ncon
nku	ncon
nkw	ncon
nkx	ncon
nkz	ncon
nla	ncon
nle	ncon
nlj	ncon
nlo	ncon
nlu	ncon
nmd	ncon
nmg	ncon
nmj	ncon
nml	ncon
nmq	ncon
nmr	ncon
nmz	ncon
nnb	ncon
nne	ncon
nnh	ncon
nnq	ncon
nns	ncon
nnu	ncon
nnw	ncon
nnx	ncon
nnz	ncon
noq	ncon
now	ncon
noy	ncon
nqg	ncon
nqk	ncon
nra	ncon
nsc	ncon
nse	ncon
nsh	ncon
nso	ncon
nsx	ncon
nte	ncon
nti	ncon
ntk	ncon
ntm	ncon
nto	ncon
ntr	ncon
nue	ncon
nuh	ncon
nui	ncon
nuj	ncon
nup	ncon
nuu	ncon
nuv	ncon
nwb	ncon
nwe	ncon
nxd	ncon
nxi	ncon
nya	ncon
nyb	ncon
nyc	ncon
nyd	ncon
nye	ncon
nyf	ncon
nyg	ncon
nyj	ncon
nyk	ncon
nym	ncon
nyn	ncon
nyo	ncon
nyu	ncon
nyy	ncon
nza	ncon
nzb	ncon
nzi	ncon
nzk	ncon
nzu	ncon
nzy	ncon
obl	ncon
obu	ncon
oda	ncon
odu	ncon
ofu	ncon
ogb	ncon
ogc	ncon
ogg	ncon
ogo	ncon
ogu	ncon
okb	ncon
okd	ncon
oke	ncon
okr	ncon
oks	ncon
oku	ncon
okx	ncon
old	ncon
olm	ncon
oml	ncon
opa	ncon
org	ncon
orr	ncon
orx	ncon
oso	ncon
ost	ncon
otr	ncon
oub	ncon
ozm	ncon
pae	ncon
pai	ncon
pbl	ncon
pbn	ncon
pbo	ncon
pbp	ncon
pbr	ncon
pcn	ncon
pem	ncon
pfe	ncon
pgs	ncon
phm	ncon
pic	ncon
pil	ncon
piw	ncon
pkb	ncon
plr	ncon
pmb	ncon
pmm	ncon
pmn	ncon
png	ncon
pnq	ncon
pny	ncon
pnz	ncon
pof	ncon
poj	ncon
poy	ncon
ppp	ncon
pug	ncon
puu	ncon
pye	ncon
pym	ncon
rag	ncon
ras	ncon
rax	ncon
reg	ncon
res	ncon
rim	ncon
rin	ncon
rkm	ncon
rnd	ncon
rng	ncon
rnw	ncon
rod	ncon
rof	ncon
rub	ncon
ruc	ncon
ruf	ncon
rui	ncon
ruk	ncon
run	ncon
ruy	ncon
ruz	ncon
rwk	ncon
rwm	ncon
saf	ncon
sak	ncon
sav	ncon
sbd	ncon
sbk	ncon
sbm	ncon
sbp	ncon
sbs	ncon
sbw	ncon
sby	ncon
scv	ncon
sde	ncon
sdj	ncon
seb	ncon
sef	ncon
seg	ncon
seh	ncon
sen	ncon
sep	ncon
seq	ncon
sev	ncon
sfw	ncon
sgi	ncon
sgm	ncon
sgo	ncon
sha	ncon
shc	ncon
sho	ncon
shq	ncon
shr	ncon
shw	ncon
shz	ncon
sie	ncon
sif	ncon
sig	ncon
sil	ncon
skq	ncon
skt	ncon
sld	ncon
slx	ncon
smd	ncon
smx	ncon
sna	ncon
snf	ncon
sng	ncon
snk	ncon
snq	ncon
snw	ncon
soc	ncon
sod	ncon
soe	ncon
soo	ncon
sop	ncon
sos	ncon
sot	ncon
sox	ncon
soy	ncon
soz	ncon
spp	ncon
sqa	ncon
sqh	ncon
sqm	ncon
srr	ncon
ssl	ncon
ssw	ncon
stj	ncon
sub	ncon
suh	ncon
suj	ncon
suk	ncon
sus	ncon
suw	ncon
swb	ncon
swc	ncon
swf	ncon
swh	ncon
swj	ncon
swk	ncon
sxe	ncon
sxs	ncon
sxw	ncon
syi	ncon
sym	ncon
szg	ncon
szk	ncon
szv	ncon
tag	ncon
tap	ncon
taz	ncon
tbm	ncon
tbt	ncon
tbz	ncon
tcd	ncon
tck	ncon
tdl	ncon
tdo	ncon
tdq	ncon
tdv	ncon
ted	ncon
teg	ncon
tek	ncon
tem	ncon
tfi	ncon
tga	ncon
tgw	ncon
tgy	ncon
thk	ncon
thy	ncon
tic	ncon
tie	ncon
tii	ncon
tik	ncon
tiq	ncon
tiv	ncon
tja	ncon
tjn	ncon
tke	ncon
tkq	ncon
tlj	ncon
tll	ncon
tlo	ncon
tms	ncon
tmv	ncon
tnr	ncon
tny	ncon
tod	ncon
tog	ncon
toh	ncon
toi	ncon
tor	ncon
toz	ncon
tpm	ncon
tqr	ncon
tsa	ncon
tsc	ncon
tsn	ncon
tso	ncon
tsp	ncon
tsv	ncon
tsw	ncon
ttb	ncon
ttf	ncon
ttj	ncon
ttl	ncon
tug	ncon
tui	ncon
tul	ncon
tum	ncon
tuz	ncon
tvd	ncon
tvs	ncon
twl	ncon
twn	ncon
two	ncon
twx	ncon
tye	ncon
tyi	ncon
tyx	ncon
uba	ncon
uda	ncon
uha	ncon
uiv	ncon
uji	ncon
ukh	ncon
ukp	ncon
ukq	ncon
uku	ncon
ukw	ncon
ula	ncon
ulb	ncon
umb	ncon
umm	ncon
une	ncon
uok	ncon
urh	ncon
usk	ncon
uta	ncon
utr	ncon
uya	ncon
vag	ncon
vai	ncon
vau	ncon
ven	ncon
ver	ncon
vid	ncon
vif	ncon
vig	ncon
vin	ncon
vit	ncon
vki	ncon
vmk	ncon
vmr	ncon
vmw	ncon
vor	ncon
vum	ncon
vun	ncon
vut	ncon
wan	ncon
wav	ncon
wbf	ncon
wbh	ncon
wbi	ncon
wci	ncon
wdd	ncon
wec	ncon
weh	ncon
wem	ncon
wib	ncon
wja	ncon
wlc	ncon
wlx	ncon
wmw	ncon
wni	ncon
wob	ncon
wof	ncon
wok	ncon
wol	ncon
wom	ncon
won	ncon
wre	ncon
wrn	ncon
wss	ncon
wud	ncon
wum	ncon
wun	ncon
wwa	ncon
www	ncon
xho	ncon
xkb	ncon
xkg	ncon
xkt	ncon
xku	ncon
xkv	ncon
xma	ncon
xmb	ncon
xmc	ncon
xmg	ncon
xog	ncon
xon	ncon
xpe	ncon
xrb	ncon
xsh	ncon
xsj	ncon
xsm	ncon
xsn	ncon
xsq	ncon
xuo	ncon
xwe	ncon
xwl	ncon
yaf	ncon
yaj	ncon
yal	ncon
yam	ncon
yao	ncon
yas	ncon
yat	ncon
yav	ncon
yay	ncon
yaz	ncon
yba	ncon
ybb	ncon
ybj	ncon
ybl	ncon
yel	ncon
yen	ncon
yer	ncon
yes	ncon
yey	ncon
yko	ncon
yky	ncon
ymg	ncon
ymk	ncon
yng	ncon
ynh	ncon
yns	ncon
yom	ncon
yor	ncon
yre	ncon
yun	ncon
zaj	ncon
zak	ncon
zdj	ncon
zga	ncon
zhi	ncon
zhw	ncon
zin	ncon
zir	ncon
ziw	ncon
zmb	ncon
zmf	ncon
zmn	ncon
zmp	ncon
zmq	ncon
zms	ncon
zmw	ncon
zmx	ncon
zmz	ncon
zna	ncon
zne	ncon
zul	ncon
aam	nsah
ach	nsah
adh	nsah
aft	nsah
aja	nsah
alz	nsah
amj	nsah
anu	nsah
asv	nsah
atu	nsah
avu	nsah
bct	nsah
bdh	nsah
bdi	nsah
bdo	nsah
bex	nsah
bfa	nsah
bjv	nsah
blm	nsah
bmi	nsah
bms	nsah
bot	nsah
brk	nsah
bvq	nsah
bxb	nsah
bxv	nsah
byg	nsah
byt	nsah
daj	nsah
dau	nsah
ddd	nsah
ddn	nsah
dgk	nsah
dib	nsah
did	nsah
dik	nsah
dil	nsah
dip	nsah
diw	nsah
djc	nsah
dje	nsah
dks	nsah
drb	nsah
dsi	nsah
dsq	nsah
dzg	nsah
efe	nsah
elh	nsah
enb	nsah
fgr	nsah
fia	nsah
fuu	nsah
fvr	nsah
gbn	nsah
ghl	nsah
glu	nsah
gly	nsah
gqr	nsah
guk	nsah
gvl	nsah
hmb	nsah
hor	nsah
ikx	nsah
jum	nsah
jyy	nsah
kbl	nsah
kbo	nsah
kby	nsah
kcm	nsah
kcp	nsah
kcy	nsah
kdi	nsah
kdj	nsah
kdu	nsah
kec	nsah
keg	nsah
keo	nsah
kgo	nsah
khq	nsah
kie	nsah
kko	nsah
klf	nsah
kln	nsah
kmq	nsah
knc	nsah
koe	nsah
koj	nsah
kpz	nsah
kqh	nsah
krs	nsah
krt	nsah
ksp	nsah
kth	nsah
kun	nsah
kwg	nsah
kwv	nsah
kxj	nsah
kyq	nsah
kzh	nsah
laj	nsah
lap	nsah
led	nsah
les	nsah
lgg	nsah
lgn	nsah
liu	nsah
lkr	nsah
lky	nsah
lmi	nsah
lno	nsah
log	nsah
loh	nsah
lot	nsah
lpx	nsah
luc	nsah
lul	nsah
luo	nsah
lwo	nsah
mas	nsah
mde	nsah
mdg	nsah
mdi	nsah
mdj	nsah
mdk	nsah
mei	nsah
mfz	nsah
mgb	nsah
mgc	nsah
mgd	nsah
mge	nsah
mhi	nsah
miv	nsah
mls	nsah
mne	nsah
mpe	nsah
mqu	nsah
mur	nsah
muz	nsah
mvu	nsah
mwm	nsah
mwu	nsah
mwx	nsah
mwy	nsah
mxh	nsah
myb	nsah
mym	nsah
ndp	nsah
ndy	nsah
niy	nsah
njl	nsah
nmc	nsah
nnj	nsah
nrb	nsah
nsg	nsah
nus	nsah
nwm	nsah
nyi	nsah
nyp	nsah
oki	nsah
omi	nsah
omt	nsah
pko	nsah
rou	nsah
saq	nsah
sba	nsah
sbf	nsah
sbj	nsah
sbz	nsah
ses	nsah
shj	nsah
shk	nsah
sjg	nsah
snm	nsah
soh	nsah
spy	nsah
suq	nsah
sys	nsah
tbi	nsah
tbr	nsah
tcc	nsah
teo	nsah
teq	nsah
teu	nsah
tex	nsah
tey	nsah
thu	nsah
tle	nsah
tma	nsah
toq	nsah
tuq	nsah
tuv	nsah
tuy	nsah
twq	nsah
udu	nsah
vae	nsah
wll	nsah
wti	nsah
xel	nsah
xom	nsah
xtc	nsah
xwg	nsah
yul	nsah
zag	nsah
zmo	nsah
bhf	ocis
bsa	ocis
bzu	ocis
nce	ocis
prm	ocis
yuj	ocis
amu	otma
azg	otma
azm	otma
cco	otma
chj	otma
chq	otma
chz	otma
cip	otma
cjr	otma
cle	otma
cly	otma
cnl	otma
cnt	otma
coz	otma
cpa	otma
csa	otma
cso	otma
cta	otma
cte	otma
ctl	otma
ctp	otma
ctz	otma
cuc	otma
cut	otma
cux	otma
cvn	otma
cya	otma
czn	otma
ixc	otma
jmx	otma
maa	otma
mab	otma
maj	otma
maq	otma
mat	otma
mau	otma
maz	otma
mbz	otma
mce	otma
mdv	otma
meh	otma
mib	otma
mie	otma
mig	otma
mih	otma
mii	otma
mil	otma
mim	otma
mio	otma
mip	otma
mit	otma
miu	otma
mix	otma
miy	otma
miz	otma
mjc	otma
mks	otma
mmc	otma
mpm	otma
mqh	otma
mtu	otma
mtx	otma
mvg	otma
mxa	otma
mxb	otma
mxs	otma
mxt	otma
mxv	otma
mxy	otma
mza	otma
mzi	otma
ocu	otma
ote	otma
otl	otma
otm	otma
otn	otma
otq	otma
ots	otma
ott	otma
otx	otma
otz	otma
pbe	otma
pbf	otma
pbs	otma
pca	otma
pei	otma
pls	otma
pmq	otma
pmz	otma
poe	otma
pow	otma
pps	otma
trc	otma
trq	otma
trs	otma
vmc	otma
vmj	otma
vmm	otma
vmp	otma
vmq	otma
vmx	otma
vmy	otma
vmz	otma
xta	otma
xtb	otma
xtd	otma
xti	otma
xtj	otma
xtl	otma
xtm	otma
xtn	otma
xtp	otma
xts	otma
xtt	otma
xtu	otma
xty	otma
zaa	otma
zab	otma
zac	otma
zad	otma
zae	otma
zaf	otma
zai	otma
zam	otma
zao	otma
zaq	otma
zar	otma
zas	otma
zat	otma
zav	otma
zaw	otma
zax	otma
zca	otma
zoo	otma
zpa	otma
zpb	otma
zpc	otma
zpd	otma
zpe	otma
zpf	otma
zpg	otma
zph	otma
zpi	otma
zpj	otma
zpk	otma
zpl	otma
zpm	otma
zpn	otma
zpo	otma
zpp	otma
zpq	otma
zpr	otma
zps	otma
zpt	otma
zpu	otma
zpv	otma
zpw	otma
zpx	otma
zpy	otma
zpz	otma
zsr	otma
ztc	otma
zte	otma
ztg	otma
ztl	otma
ztm	otma
ztn	otma
ztp	otma
ztq	otma
zts	otma
ztt	otma
ztu	otma
ztx	otma
zty	otma
amc	pano
atc	pano
cao	pano
cbr	pano
cbs	pano
isc	pano
kaq	pano
knt	pano
ktx	pano
mcd	pano
mcf	pano
mpq	pano
mts	pano
mzr	pano
nom	pano
nuc	pano
pcp	pano
pig	pano
pno	pano
pyn	pano
rem	pano
shp	pano
snh	pano
sni	pano
tux	pano
xip	pano
yaa	pano
ywn	pano
bfe	paun
dol	paun
khh	paun
lpe	paun
rmh	paun
tqm	paun
xkw	paun
yad	pbya
yme	pbya
aes	penu
chh	penu
csi	penu
csm	penu
css	penu
cst	penu
csz	penu
git	penu
kla	penu
krb	penu
kyl	penu
lmw	penu
mbe	penu
mjd	penu
mkq	penu
ncg	penu
nez	penu
nmu	penu
nsq	penu
nsz	penu
pmw	penu
sis	penu
skd	penu
tkm	penu
tqn	penu
tsi	penu
uma	penu
vmv	penu
waa	penu
wac	penu
wit	penu
yak	penu
yok	penu
cqu	quch
inb	quch
inj	quch
qub	quch
qud	quch
quf	quch
qug	quch
quh	quch
quk	quch
qul	quch
qup	quch
qur	quch
qus	quch
quw	quch
qux	quch
quy	quch
quz	quch
qva	quch
qvc	quch
qve	quch
qvh	quch
qvi	quch
qvj	quch
qvl	quch
qvm	quch
qvn	quch
qvo	quch
qvp	quch
qvs	quch
qvw	quch
qvz	quch
qwa	quch
qwc	quch
qwh	quch
qws	quch
qxa	quch
qxc	quch
qxh	quch
qxl	quch
qxn	quch
qxo	quch
qxp	quch
qxr	quch
qxt	quch
qxu	quch
qxw	quch
blc	sali
cea	sali
cjh	sali
clm	sali
col	sali
coo	sali
cow	sali
crd	sali
fla	sali
hur	sali
lil	sali
lut	sali
nok	sali
oka	sali
ptw	sali
qun	sali
sec	sali
shs	sali
ska	sali
slh	sali
sno	sali
spo	sali
squ	sali
str	sali
thp	sali
til	sali
twa	sali
ano	saso
auc	saso
cas	saso
caz	saso
cbu	saso
cyb	saso
ito	saso
kbh	saso
lec	saso
myr	saso
mzp	saso
paz	saso
pbb	saso
pue	saso
pui	saso
tca	saso
tit	saso
tpy	saso
trr	saso
tud	saso
ura	saso
wba	saso
yag	saso
yuz	saso
aga	saun
akn	saun
ash	saun
avo	saun
axg	saun
cbe	saun
cbh	saun
cby	saun
hir	saun
iap	saun
kob	saun
kox	saun
kuz	saun
kzw	saun
nts	saun
pax	saun
pij	saun
ppv	saun
pth	saun
puq	saun
tbb	saun
tgv	saun
tka	saun
tme	saun
uam	saun
urp	saun
waf	saun
wsu	saun
xai	saun
xba	saun
xbw	saun
xkh	saun
xmi	saun
xoo	saun
xor	saun
xpn	saun
yae	saun
yau	saun
yri	saun
aad	sepr
aau	sepr
abt	sepr
ado	sepr
aew	sepr
afi	sepr
aki	sepr
akq	sepr
amp	sepr
anj	sepr
aod	sepr
aog	sepr
arf	sepr
aww	sepr
aya	sepr
ayq	sepr
bic	sepr
bit	sepr
bjh	sepr
bnw	sepr
bqs	sepr
brq	sepr
bry	sepr
buv	sepr
bwm	sepr
bye	sepr
byz	sepr
bzf	sepr
can	sepr
cga	sepr
cjn	sepr
dju	sepr
gai	sepr
gbe	sepr
gbf	sepr
geb	sepr
gpn	sepr
grq	sepr
ham	sepr
ian	sepr
igg	sepr
igm	sepr
itu	sepr
iwa	sepr
iwm	sepr
iws	sepr
kbx	sepr
kct	sepr
kmn	sepr
kmo	sepr
knr	sepr
kql	sepr
kwj	sepr
kxt	sepr
lgt	sepr
lnm	sepr
mbx	sepr
mgt	sepr
mle	sepr
msy	sepr
mtf	sepr
mvk	sepr
myd	sepr
mzu	sepr
nnm	sepr
nud	sepr
nux	sepr
pin	sepr
ppe	sepr
ppq	sepr
psq	sepr
rao	sepr
rmk	sepr
sbt	sepr
seo	sepr
sic	sepr
sim	sepr
siv	sepr
sny	sepr
spk	sepr
spm	sepr
tbs	sepr
tgu	sepr
tww	sepr
tzx	sepr
wax	sepr
wla	sepr
wog	sepr
wos	sepr
wtk	sepr
xoi	sepr
xop	sepr
xrw	sepr
ybx	sepr
yee	sepr
yet	sepr
yla	sepr
ylg	sepr
yra	sepr
yss	sepr
ywa	sepr
asb	siou
bll	siou
chc	siou
cro	siou
dak	siou
hid	siou
iow	siou
ksk	siou
lkt	siou
mhq	siou
ofo	siou
oma	siou
osa	siou
qua	siou
sto	siou
tta	siou
win	siou
acn	sitb
adi	sitb
adl	sitb
adp	sitb
adx	sitb
ahk	sitb
aim	sitb
ajz	sitb
anl	sitb
anm	sitb
aot	sitb
aph	sitb
apt	sitb
atb	sitb
atf	sitb
ayx	sitb
bap	sitb
bca	sitb
bee	sitb
bfc	sitb
bfs	sitb
bft	sitb
bfu	sitb
bgg	sitb
bgr	sitb
bhj	sitb
bii	sitb
biu	sitb
blk	sitb
bod	sitb
bqh	sitb
brd	sitb
bro	sitb
brx	sitb
bwe	sitb
bxd	sitb
byh	sitb
byo	sitb
byw	sitb
cbl	sitb
ccq	sitb
cda	sitb
cdf	sitb
cdm	sitb
cdn	sitb
cdo	sitb
cgk	sitb
chx	sitb
cik	sitb
cjy	sitb
cka	sitb
clk	sitb
cmn	sitb
cmr	sitb
cna	sitb
cnb	sitb
cnc	sitb
cng	sitb
cnh	sitb
cnk	sitb
cnw	sitb
cpx	sitb
csh	sitb
csy	sitb
ctd	sitb
ctn	sitb
cur	sitb
cuw	sitb
cvg	sitb
czh	sitb
czo	sitb
czt	sitb
dao	sitb
dap	sitb
dat	sitb
der	sitb
dhi	sitb
dis	sitb
dka	sitb
dln	sitb
dng	sitb
drd	sitb
dre	sitb
drq	sitb
dus	sitb
duu	sitb
dzl	sitb
dzo	sitb
eky	sitb
emg	sitb
ero	sitb
ers	sitb
flm	sitb
gan	sitb
gen	sitb
ggn	sitb
ghe	sitb
ghh	sitb
ghk	sitb
ght	sitb
gnb	sitb
goe	sitb
gqi	sitb
gro	sitb
grt	sitb
gvr	sitb
hak	sitb
hlt	sitb
hmr	sitb
hni	sitb
how	sitb
hpo	sitb
hra	sitb
hru	sitb
hsn	sitb
hut	sitb
iii	sitb
int	sitb
jda	sitb
jee	sitb
jih	sitb
jiq	sitb
jiu	sitb
jiy	sitb
jna	sitb
jnl	sitb
jul	sitb
jya	sitb
kac	sitb
kbg	sitb
kdq	sitb
kds	sitb
kdv	sitb
kfk	sitb
kfw	sitb
kgg	sitb
kgj	sitb
kgy	sitb
khg	sitb
kif	sitb
kip	sitb
kjl	sitb
kjp	sitb
kjt	sitb
kjz	sitb
kkf	sitb
kkt	sitb
kle	sitb
klr	sitb
kmm	sitb
kpp	sitb
ksw	sitb
kte	sitb
ktp	sitb
kvl	sitb
kvq	sitb
kvt	sitb
kvu	sitb
kvy	sitb
kxf	sitb
kxk	sitb
kyu	sitb
kzq	sitb
lae	sitb
lax	sitb
lay	sitb
lba	sitb
lbf	sitb
lbg	sitb
lbj	sitb
lbr	sitb
lep	sitb
lgh	sitb
lhm	sitb
lhp	sitb
lhu	sitb
lif	sitb
lii	sitb
lis	sitb
lkh	sitb
lmh	sitb
lmk	sitb
lov	sitb
loy	sitb
lpo	sitb
lrr	sitb
lsh	sitb
lsi	sitb
luk	sitb
lus	sitb
luu	sitb
lya	sitb
mef	sitb
mgp	sitb
mhu	sitb
mhv	sitb
mhx	sitb
mja	sitb
mjw	sitb
mni	sitb
mnp	sitb
mob	sitb
mpz	sitb
mrd	sitb
mrg	sitb
mrh	sitb
mro	sitb
muk	sitb
mvm	sitb
mwq	sitb
mxj	sitb
mya	sitb
nan	sitb
nao	sitb
nbc	sitb
nbe	sitb
nbf	sitb
nbi	sitb
nbt	sitb
nbu	sitb
ncd	sitb
nct	sitb
neh	sitb
nes	sitb
new	sitb
njb	sitb
njh	sitb
njm	sitb
njn	sitb
njo	sitb
nkb	sitb
nkd	sitb
nkf	sitb
nkh	sitb
nki	sitb
nky	sitb
nma	sitb
nme	sitb
nmf	sitb
nmh	sitb
nmm	sitb
nmo	sitb
nmy	sitb
nng	sitb
nnl	sitb
nnp	sitb
nos	sitb
npa	sitb
npb	sitb
nph	sitb
npo	sitb
npu	sitb
nre	sitb
nri	sitb
nrr	sitb
nsa	sitb
nsm	sitb
nst	sitb
nty	sitb
nuf	sitb
nun	sitb
nzm	sitb
ola	sitb
ole	sitb
onp	sitb
pbz	sitb
pck	sitb
pcr	sitb
pdu	sitb
pgy	sitb
phh	sitb
pho	sitb
phq	sitb
phw	sitb
pkh	sitb
pmi	sitb
pmj	sitb
pmx	sitb
ppa	sitb
prx	sitb
pub	sitb
pum	sitb
puz	sitb
pwo	sitb
pww	sitb
pyy	sitb
qvy	sitb
qxs	sitb
raa	sitb
rab	sitb
raf	sitb
rah	sitb
ral	sitb
raq	sitb
rau	sitb
rav	sitb
raw	sitb
rgk	sitb
ria	sitb
rji	sitb
rki	sitb
rmz	sitb
rnl	sitb
rnp	sitb
ruh	sitb
sbu	sitb
sca	sitb
sch	sitb
scp	sitb
scu	sitb
sdp	sitb
sez	sitb
sgp	sitb
sgt	sitb
shl	sitb
sip	sitb
sjl	sitb
skj	sitb
slt	sitb
smh	sitb
smt	sitb
spt	sitb
ssk	sitb
suv	sitb
suz	sitb
sxg	sitb
syw	sitb
taj	sitb
tcl	sitb
tcn	sitb
tco	sitb
tcp	sitb
tcz	sitb
tdg	sitb
tdh	sitb
tge	sitb
tgf	sitb
thf	sitb
ths	sitb
thw	sitb
tij	sitb
tji	sitb
tjs	sitb
tkk	sitb
tmk	sitb
tmx	sitb
tpq	sitb
tro	sitb
trp	sitb
tsf	sitb
tsj	sitb
tsk	sitb
ttz	sitb
tvn	sitb
tvt	sitb
twm	sitb
txo	sitb
ugo	sitb
vap	sitb
vay	sitb
wea	sitb
weu	sitb
wly	sitb
wme	sitb
wuu	sitb
xac	sitb
xia	sitb
xkf	sitb
xkz	sitb
xns	sitb
xsr	sitb
ybd	sitb
ybh	sitb
ybi	sitb
ycl	sitb
yif	sitb
yig	sitb
yik	sitb
yim	sitb
yio	sitb
yip	sitb
yiq	sitb
yit	sitb
yiu	sitb
yiv	sitb
yix	sitb
yiz	sitb
ylm	sitb
ylo	sitb
yma	sitb
ymh	sitb
ymj	sitb
yos	sitb
ypl	sitb
ypw	sitb
ysn	sitb
yso	sitb
ysp	sitb
yue	sitb
ywl	sitb
ywm	sitb
ywq	sitb
ywt	sitb
ywu	sitb
yym	sitb
zal	sitb
zau	sitb
zhb	sitb
zkr	sitb
zom	sitb
zyp	sitb
ksi	skoo
pux	skoo
rwa	skoo
skv	skoo
vam	skoo
wra	skoo
wut	skoo
pid	slvn
slc	slvn
wpc	slvn
sut	subt
tcf	subt
tpc	subt
tpl	subt
tpx	subt
aro	taca
cav	taca
ese	taca
rey	taca
tna	taca
tno	taca
aho	taik
aih	taik
aio	taik
blt	taik
byk	taik
byu	taik
ccx	taik
ccy	taik
cov	taik
cuq	taik
cuu	taik
doc	taik
eee	taik
enc	taik
gio	taik
giq	taik
gir	taik
giw	taik
jio	taik
khb	taik
kht	taik
kkh	taik
kmc	taik
ksu	taik
kyp	taik
lao	taik
laq	taik
lbc	taik
lbt	taik
lha	taik
lic	taik
lwh	taik
mkg	taik
mlc	taik
mlm	taik
mmd	taik
nod	taik
nut	taik
nyw	taik
onb	taik
pcc	taik
pdi	taik
phk	taik
pht	taik
phu	taik
puk	taik
rie	taik
shn	taik
skb	taik
soa	taik
sou	taik
swi	taik
tct	taik
tdd	taik
tha	taik
thc	taik
thi	taik
tiz	taik
tmm	taik
tmp	taik
tnu	taik
tpo	taik
try	taik
tsl	taik
tts	taik
twh	taik
tyj	taik
tyl	taik
tyr	taik
tys	taik
tyt	taik
tyz	taik
uan	taik
yno	taik
yoy	taik
yrn	taik
zgb	taik
zgn	taik
zhn	taik
zlj	taik
zln	taik
zqe	taik
zyb	taik
zyg	taik
zyj	taik
zyn	taik
zzj	taik
pua	tara
tsz	tara
aif	torr
alx	torr
aof	torr
aoj	torr
aon	torr
ape	torr
auk	torr
aun	torr
aur	torr
avt	torr
bey	torr
but	torr
bvn	torr
dia	torr
eit	torr
ele	torr
elk	torr
gnu	torr
kms	torr
lkl	torr
lll	torr
lsr	torr
mkc	torr
mty	torr
mwb	torr
mxk	torr
mzf	torr
niz	torr
oin	torr
okk	torr
ong	torr
onk	torr
onr	torr
osu	torr
rhp	torr
sbi	torr
siu	torr
stf	torr
tei	torr
tua	torr
uri	torr
urt	torr
urx	torr
van	torr
wii	torr
wmo	torr
wnp	torr
xbi	torr
yev	torr
yis	torr
yll	torr
ymb	torr
yyu	torr
tee	toto
tlc	toto
tlp	toto
toc	toto
too	toto
top	toto
tos	toto
tot	toto
tpp	toto
tpt	toto
tqt	toto
aac	trng
aak	trng
aax	trng
abg	trng
abw	trng
aby	trng
abz	trng
adb	trng
adn	trng
aey	trng
agd	trng
age	trng
agg	trng
agl	trng
agm	trng
ago	trng
ahh	trng
aic	trng
ail	trng
aip	trng
air	trng
akh	trng
ali	trng
amn	trng
anh	trng
aob	trng
aoe	trng
aom	trng
aos	trng
apz	trng
aqm	trng
asc	trng
asd	trng
asi	trng
aso	trng
asx	trng
asy	trng
ate	trng
aup	trng
auu	trng
auw	trng
auy	trng
awb	trng
awi	trng
awm	trng
aws	trng
awu	trng
awv	trng
awx	trng
awy	trng
bbb	trng
bbd	trng
bbr	trng
bcf	trng
bco	trng
bdw	trng
bef	trng
beo	trng
beu	trng
bfh	trng
bfn	trng
bgv	trng
bhg	trng
bhl	trng
bie	trng
big	trng
bir	trng
bjc	trng
bjr	trng
bjz	trng
bkl	trng
bmh	trng
bmp	trng
bmu	trng
bmx	trng
bmz	trng
bnv	trng
boj	trng
bon	trng
bop	trng
boq	trng
bow	trng
bpi	trng
bpm	trng
bpp	trng
bpu	trng
bpv	trng
bqb	trng
bql	trng
buq	trng
bwk	trng
bwp	trng
bxz	trng
byr	trng
bzp	trng
cjv	trng
cns	trng
dah	trng
daz	trng
dbe	trng
dbn	trng
dby	trng
ddg	trng
ded	trng
dem	trng
dev	trng
dge	trng
dgx	trng
dgz	trng
diy	trng
dmc	trng
dmu	trng
dmy	trng
dna	trng
dnd	trng
dni	trng
dnr	trng
dnt	trng
dnw	trng
doa	trng
dof	trng
duc	trng
dui	trng
duk	trng
eip	trng
ekg	trng
ena	trng
enq	trng
enr	trng
eri	trng
etr	trng
etz	trng
faa	trng
fad	trng
fag	trng
fai	trng
faj	trng
fiw	trng
foi	trng
for	trng
frq	trng
fuy	trng
gaf	trng
gah	trng
gaj	trng
gam	trng
gao	trng
gap	trng
gat	trng
gav	trng
gaw	trng
gcn	trng
gdn	trng
gdr	trng
ggl	trng
ggw	trng
ghs	trng
gim	trng
gka	trng
gmu	trng
gnm	trng
gnt	trng
goi	trng
grg	trng
grs	trng
gsn	trng
gsp	trng
gvf	trng
gyb	trng
hap	trng
hih	trng
hmt	trng
hmu	trng
huf	trng
hui	trng
iar	trng
idi	trng
igo	trng
ihp	trng
imi	trng
imn	trng
imo	trng
ino	trng
iou	trng
ipi	trng
ipo	trng
irx	trng
isa	trng
itx	trng
iwo	trng
jaq	trng
jbj	trng
jei	trng
jel	trng
jet	trng
jil	trng
jko	trng
jma	trng
kau	trng
kbk	trng
kbq	trng
kbv	trng
kcb	trng
kcd	trng
kco	trng
kdw	trng
kdy	trng
kew	trng
kgf	trng
kgq	trng
kgu	trng
kgv	trng
khd	trng
khe	trng
khp	trng
khs	trng
kig	trng
kih	trng
kiq	trng
kit	trng
kiw	trng
kja	trng
kjd	trng
kjs	trng
kjy	trng
kkc	trng
kkl	trng
klh	trng
klm	trng
klp	trng
klq	trng
klt	trng
klz	trng
kmf	trng
kmg	trng
kmh	trng
kmt	trng
kmu	trng
kmx	trng
knd	trng
knv	trng
kop	trng
koz	trng
kpf	trng
kpq	trng
kpr	trng
kpu	trng
kpw	trng
kpx	trng
kqa	trng
kqb	trng
kqc	trng
kqi	trng
krg	trng
krz	trng
ksj	trng
ksr	trng
kti	trng
kts	trng
ktt	trng
kue	trng
kuo	trng
kup	trng
kvd	trng
kvg	trng
kvw	trng
kvz	trng
kwe	trng
kwr	trng
kwt	trng
kxq	trng
kxw	trng
kxz	trng
kyc	trng
kyg	trng
kyo	trng
kyt	trng
kyy	trng
kze	trng
kzm	trng
kzv	trng
lei	trng
leq	trng
lev	trng
luf	trng
lva	trng
mbw	trng
mcc	trng
mci	trng
mcq	trng
mcr	trng
mcv	trng
mcz	trng
mdb	trng
mdc	trng
mds	trng
meb	trng
med	trng
mfw	trng
mgf	trng
mgk	trng
mgu	trng
mgx	trng
mhf	trng
mhl	trng
miw	trng
mjj	trng
mjn	trng
mkp	trng
mkr	trng
mkz	trng
mlh	trng
mlp	trng
mmb	trng
mmi	trng
mmq	trng
mnm	trng
mnu	trng
mnz	trng
mok	trng
moq	trng
mpp	trng
mps	trng
mpt	trng
mpv	trng
mqe	trng
mqf	trng
mqr	trng
mqv	trng
mqw	trng
mrf	trng
mrx	trng
mrz	trng
msf	trng
msl	trng
mso	trng
msx	trng
msz	trng
mtc	trng
mtg	trng
mti	trng
mtv	trng
mux	trng
mvq	trng
mvs	trng
mxw	trng
mze	trng
nac	trng
naf	trng
nbk	trng
nbq	trng
nby	trng
nca	trng
ncm	trng
ndx	trng
nec	trng
nej	trng
ner	trng
net	trng
nex	trng
nib	trng
nif	trng
nii	trng
nir	trng
nis	trng
nkg	trng
nkj	trng
nkm	trng
nks	trng
nlc	trng
nlk	trng
nmx	trng
nnf	trng
nnk	trng
noc	trng
nof	trng
noh	trng
nop	trng
nou	trng
nps	trng
nqm	trng
nqn	trng
nvm	trng
nwr	trng
nxr	trng
nxu	trng
nxx	trng
oia	trng
omo	trng
omw	trng
onj	trng
onn	trng
ons	trng
ont	trng
opk	trng
opm	trng
opo	trng
ork	trng
oro	trng
pda	trng
ped	trng
pep	trng
pgi	trng
pla	trng
pmr	trng
pnn	trng
pnr	trng
ppo	trng
ppt	trng
pru	trng
prw	trng
psa	trng
pup	trng
pwa	trng
ran	trng
rea	trng
ret	trng
rmp	trng
rpt	trng
rwo	trng
sao	trng
saw	trng
sbq	trng
sej	trng
set	trng
siq	trng
six	trng
skc	trng
skm	trng
sks	trng
sll	trng
slw	trng
smb	trng
smc	trng
smf	trng
smq	trng
snp	trng
snr	trng
snu	trng
snx	trng
snz	trng
soq	trng
sow	trng
spd	trng
spl	trng
sra	trng
srl	trng
ssd	trng
ssj	trng
sst	trng
ssu	trng
ssx	trng
stk	trng
stm	trng
sue	trng
sug	trng
sui	trng
swm	trng
swt	trng
szb	trng
szp	trng
taw	trng
tbd	trng
tbg	trng
tbv	trng
tcg	trng
tci	trng
tcm	trng
tif	trng
tim	trng
tip	trng
tkx	trng
tlf	trng
tlg	trng
tmd	trng
tmj	trng
tml	trng
tnh	trng
tnm	trng
tof	trng
tpg	trng
tqo	trng
trh	trng
tsx	trng
ttd	trng
ttn	trng
twe	trng
twg	trng
txt	trng
tya	trng
tyn	trng
uar	trng
ubu	trng
ufi	trng
uhn	trng
uka	trng
ukg	trng
ulf	trng
ulk	trng
upi	trng
urg	trng
urm	trng
urw	trng
ury	trng
usa	trng
usu	trng
utu	trng
uvh	trng
wai	trng
waj	trng
wdg	trng
wei	trng
wer	trng
wfg	trng
wgi	trng
whg	trng
wiu	trng
wlw	trng
wmc	trng
wms	trng
wnb	trng
wnc	trng
wng	trng
wno	trng
wnu	trng
wod	trng
woi	trng
wrs	trng
wrv	trng
wsk	trng
wsr	trng
wtf	trng
wul	trng
xar	trng
xau	trng
xes	trng
xeu	trng
xla	trng
xod	trng
xow	trng
xse	trng
xsp	trng
xte	trng
xwr	trng
yac	trng
ybm	trng
ybo	trng
yby	trng
ydk	trng
ygm	trng
ygr	trng
ygw	trng
yir	trng
ykr	trng
yli	trng
ynl	trng
yon	trng
yrb	trng
yrw	trng
yut	trng
yuw	trng
zia	trng
zik	trng
zrs	trng
zuh	trng
arj	tucn
bao	tucn
bsn	tucn
cbc	tucn
coe	tucn
cub	tucn
des	tucn
gvc	tucn
mcl	tucn
mmv	tucn
myy	tucn
ore	tucn
pir	tucn
pok	tucn
sey	tucn
snn	tucn
sri	tucn
tav	tucn
teb	tucn
ten	tucn
tnc	tucn
tue	tucn
tuo	tucn
ynu	tucn
yui	tucn
aan	tupi
adw	tupi
ait	tupi
ama	tupi
api	tupi
arr	tupi
arx	tupi
asn	tupi
asu	tupi
aux	tupi
avv	tupi
awe	tupi
awt	tupi
cin	tupi
cod	tupi
eme	tupi
gnw	tupi
gub	tupi
gug	tupi
gui	tupi
gun	tupi
guq	tupi
gvj	tupi
gvo	tupi
gyr	tupi
jor	tupi
jua	tupi
jur	tupi
kay	tupi
kgk	tupi
kgm	tupi
kpn	tupi
ktn	tupi
kuq	tupi
kxo	tupi
kyr	tupi
kyz	tupi
mav	tupi
mdz	tupi
mnd	tupi
mpu	tupi
msp	tupi
myu	tupi
nhd	tupi
omg	tupi
oym	tupi
paf	tupi
pah	tupi
pak	tupi
pog	tupi
psm	tupi
pta	tupi
pto	tupi
pur	tupi
skf	tupi
srq	tupi
sru	tupi
taf	tupi
tkf	tupi
tpj	tupi
tpk	tupi
tpn	tupi
tpr	tupi
tpw	tupi
tqb	tupi
twt	tupi
urb	tupi
uru	tupi
urz	tupi
wir	tupi
wyr	tupi
xet	tupi
xiy	tupi
xmo	tupi
yrl	tupi
yuq	tupi
cap	urch
ure	urch
enf	urlc
enh	urlc
est	urlc
fin	urlc
fit	urlc
fkv	urlc
hun	urlc
izh	urlc
kca	urlc
koi	urlc
kpv	urlc
krl	urlc
liv	urlc
lud	urlc
mdf	urlc
mhr	urlc
mns	urlc
mrj	urlc
mtm	urlc
myv	urlc
nio	urlc
olo	urlc
sel	urlc
sia	urlc
sjd	urlc
sje	urlc
sjk	urlc
sjt	urlc
sju	urlc
sma	urlc
sme	urlc
smj	urlc
smn	urlc
sms	urlc
udm	urlc
vep	urlc
vot	urlc
xas	urlc
yrk	urlc
azz	utaz
chl	utaz
cok	utaz
com	utaz
crn	utaz
cup	utaz
hch	utaz
hop	utaz
lui	utaz
mfy	utaz
mnr	utaz
naz	utaz
nch	utaz
nci	utaz
ncj	utaz
ncl	utaz
ncx	utaz
ngu	utaz
nhc	utaz
nhe	utaz
nhg	utaz
nhi	utaz
nhj	utaz
nhk	utaz
nhm	utaz
nhn	utaz
nhp	utaz
nhq	utaz
nhs	utaz
nht	utaz
nhv	utaz
nhw	utaz
nhx	utaz
nhy	utaz
nhz	utaz
nln	utaz
nlv	utaz
ntp	utaz
nuz	utaz
ood	utaz
opt	utaz
pao	utaz
par	utaz
pia	utaz
ppl	utaz
ser	utaz
shh	utaz
stp	utaz
tac	utaz
tar	utaz
tbu	utaz
tcu	utaz
tep	utaz
thh	utaz
tla	utaz
tub	utaz
twr	utaz
ute	utaz
var	utaz
xaw	utaz
yaq	utaz
has	waka
hei	waka
kwk	waka
myh	waka
noo	waka
bmr	wita
boa	wita
hto	wita
huu	wita
hux	wita
oca	wita
akc	wpap
ayz	wpap
gak	wpap
gbi	wpap
had	wpap
ibu	wpap
kax	wpap
kgr	wpap
kgw	wpap
kps	wpap
kzz	wpap
lau	wpap
loa	wpap
mqo	wpap
mqs	wpap
msg	wpap
mxn	wpap
pgu	wpap
saj	wpap
sbg	wpap
tby	wpap
tft	wpap
tlb	wpap
tuj	wpap
tvo	wpap
wli	wpap
guu	yano
shb	yano
wca	yano
xsu	yano
ket	yeos
yuu	yeos
ykg	yuka
yux	yuka
wao	yuki
yuk	yuki
ayo	zamu
ceg	zamu
anb	zapa
arl	zapa
avs	zapa
cah	zapa
iqu	zapa
omu	zapa
zro	zapa
